cell	MaxPrediction
Normal_AAAAAAGGTTCC	CD8Memory
Normal_AAAACAACGGGG	Plasma
Normal_AAAACCGAAACC	Plasma
Normal_AAAACGCGTGCC	CD8Memory
Normal_AAAACGTATCGT	HSPC
Normal_AAAAGAGGATAG	cDC
Normal_AAAAGATCAATA	Plasma
Normal_AAAAGCAAACAG	Plasma
Normal_AAAAGGACTACA	Plasma
Normal_AAAATAGGCGGA	Plasma
Normal_AAACAATCATTT	Plasma
Normal_AAACAATGCTGG	pDC
Normal_AAACACGTTGCC	CD4Memory
Normal_AAACAGAAAGCC	HSPC
Normal_AAACATCCAGCG	CD8TermExh
Normal_AAACATTCACGA	cDC
Normal_AAACCTGGGGCT	cDC
Normal_AAACGACGCTTT	Plasma
Normal_AAACGTCGCTCA	CD8Naive
Normal_AAAGACACGCTG	HSPC
Normal_AAAGGCAGCTTA	CD4Memory
Normal_AAAGGGGTCTAC	HSPC
Normal_AAAGTATAGGCG	HSPC
Normal_AAAGTTTCTCCG	B
Normal_AAATAACATACT	Plasma
Normal_AAATAATATTCC	Plasma
Normal_AAATATTGGACT	Plasma
Normal_AAATATTTGCTT	CD4Memory
Normal_AAATCAATTGCG	Plasma
Normal_AAATCCCTTGAA	Plasma
Normal_AAATCGTGGGGA	cDC
Normal_AAATGCCATTCA	Plasma
Normal_AAATGCGGGTAT	Plasma
Normal_AAATTACTTTAT	CD8Naive
Normal_AAATTCACATAG	Plasma
Normal_AACAACCCGACA	HSPC
Normal_AACAACCGTTAA	Plasma
Normal_AACACAATTTAT	Plasma
Normal_AACACAGCTCCT	Plasma
Normal_AACACGCTCTAC	Plasma
Normal_AACAGTGTATAA	Plasma
Normal_AACATAATGGAG	HSPC
Normal_AACATCCATATT	Plasma
Normal_AACCACAACAGA	Plasma
Normal_AACCCACGTTGC	Plasma
Normal_AACCCAGATCCC	Plasma
Normal_AACCCGAGCCCT	HSPC
Normal_AACCCTCAACGA	Plasma
Normal_AACCGCTTCCTT	Plasma
Normal_AACCGTTACGCT	CD4Memory
Normal_AACGAGAGGAGC	CD4Memory
Normal_AACGCAATATGA	cDC
Normal_AACGCGCTAGAT	cDC
Normal_AACGCGCTGGCC	Plasma
Normal_AACGGAAACTAC	HSPC
Normal_AACGGTTTTACG	Plasma
Normal_AACGTAGGTAAC	Plasma
Normal_AACTAAAGCCTA	Plasma
Normal_AACTAGGACCTC	Plasma
Normal_AACTAGGGTTAT	cDC
Normal_AACTAGTCTTCT	Plasma
Normal_AACTATCCCAAC	HSPC
Normal_AACTCGGTAGAA	Plasma
Normal_AACTCTCCAGGG	Plasma
Normal_AACTGTGCTCCC	cDC
Normal_AACTTCACTCCT	Plasma
Normal_AAGAACAGCCAG	Plasma
Normal_AAGAATCCTATG	Plasma
Normal_AAGACACCTAGC	Plasma
Normal_AAGACCACTACG	Plasma
Normal_AAGACGCGCTAA	Plasma
Normal_AAGAGGCTAAAG	Plasma
Normal_AAGAGGTTAGTA	cDC
Normal_AAGATAGAGGTC	Plasma
Normal_AAGCCAGAGAGA	Plasma
Normal_AAGCCGATACCA	Plasma
Normal_AAGCGATACATC	Plasma
Normal_AAGCGGTTTGTC	HSPC
Normal_AAGCGTACACTG	Plasma
Normal_AAGCTTAGGCCA	Plasma
Normal_AAGGACATAATG	cDC
Normal_AAGGAGTACAGC	Plasma
Normal_AAGGATTCCGCT	Plasma
Normal_AAGGCAAGTTCG	Plasma
Normal_AAGGCCACGGAC	Plasma
Normal_AAGGCTGACGAG	Plasma
Normal_AAGGCTGGCTTC	Plasma
Normal_AAGGGAATAGAA	Plasma
Normal_AAGGGGCGCAAA	cDC
Normal_AAGGGTGATCTT	Plasma
Normal_AAGGGTTTCGAC	Plasma
Normal_AAGGTCAGGACG	Plasma
Normal_AAGGTCCGGTAG	Plasma
Normal_AAGGTGAGCCTG	HSPC
Normal_AAGTAAAGAATA	cDC
Normal_AAGTACAGAGAA	Plasma
Normal_AAGTCAGAAGGA	Plasma
Normal_AAGTCGCTCCGA	cDC
Normal_AAGTCTAGCTGT	cDC
Normal_AAGTGATGTCGC	Plasma
Normal_AAGTGCCTCTGC	Plasma
Normal_AAGTGCGGAGTA	Plasma
Normal_AAGTGCTCTAAC	Plasma
Normal_AAGTGTAGTTGC	Plasma
Normal_AAGTTAGCCGTC	HSPC
Normal_AATAAACCAATG	Plasma
Normal_AATAAGTGTGAG	Plasma
Normal_AATAATATTAGC	Plasma
Normal_AATACGCACACG	Plasma
Normal_AATACGTCTGCA	HSPC
Normal_AATAGAGTCGTC	HSPC
Normal_AATAGCATTACC	Plasma
Normal_AATCAAAGGAAT	Plasma
Normal_AATCAACACAGT	cDC
Normal_AATCACTGGCAG	Plasma
Normal_AATCAGCTCGCC	Plasma
Normal_AATCATTGCGTT	Plasma
Normal_AATCCATCACGG	Plasma
Normal_AATCCCGGACGC	Plasma
Normal_AATCCTATGACT	Plasma
Normal_AATCCTCAGCTA	Plasma
Normal_AATCGTTTAGGA	Plasma
Normal_AATCTCACGAAC	CD4Memory
Normal_AATCTCCACCCA	Plasma
Normal_AATCTCCTGCCT	Plasma
Normal_AATCTCTTCTTG	Plasma
Normal_AATGATTCCCGG	Plasma
Normal_AATGATTCGCCC	Plasma
Normal_AATGATTGGAAA	Plasma
Normal_AATGCCATCTTG	Plasma
Normal_AATGCGCGTAGG	Plasma
Normal_AATGCTAACAGA	Plasma
Normal_AATGCTAATCTT	Plasma
Normal_AATGCTACTTAA	Plasma
Normal_AATGCTGCTCGC	Plasma
Normal_AATGGATACCCC	Plasma
Normal_AATGGCAACACT	CD4Memory
Normal_AATGGCGGTAAC	Plasma
Normal_AATGTAATTGCT	Plasma
Normal_AATGTTCGACCC	Plasma
Normal_AATGTTTTTCGT	Plasma
Normal_AATTAATCTTAA	Plasma
Normal_AATTAGCCCAAG	cDC
Normal_AATTCAACCGTC	Plasma
Normal_AATTCCAGAGGA	Plasma
Normal_AATTCGGGGCTG	HSPC
Normal_AATTCTACTGAT	cDC
Normal_AATTGCCATGTG	Plasma
Normal_AATTGCGTACGT	Plasma
Normal_AATTGTGGGGTT	Plasma
Normal_AATTTAATCCGA	Plasma
Normal_ACAACAGCAATC	Plasma
Normal_ACAACCAGTGAC	Plasma
Normal_ACAACCCACCAT	cDC
Normal_ACAACCCCGGAA	Plasma
Normal_ACAACCGGGATG	Plasma
Normal_ACAACTAATTTT	Plasma
Normal_ACAAGCTAGAGG	Plasma
Normal_ACAAGGTTGGAA	Plasma
Normal_ACAATAAGTCTA	Plasma
Normal_ACAATCCTGGTC	HSPC
Normal_ACAATGCGCTTA	Plasma
Normal_ACAATTTGCTCA	Plasma
Normal_ACACACCTTCAA	cDC
Normal_ACACACGCCCTG	Plasma
Normal_ACACCTTACTGG	CD4Memory
Normal_ACACCTTGATAC	cDC
Normal_ACACGACAACGC	Plasma
Normal_ACACGAGTGAGG	Plasma
Normal_ACACGTGACGAT	Plasma
Normal_ACACTAATTTGC	Plasma
Normal_ACACTATGCACG	Plasma
Normal_ACACTCAGTGAA	Plasma
Normal_ACACTCCCGGTC	CD4Memory
Normal_ACACTGAGTTGA	Plasma
Normal_ACACTTGCATAG	HSPC
Normal_ACAGATGGATCT	Plasma
Normal_ACAGCCTATGGA	Plasma
Normal_ACAGCTTCCCTA	Plasma
Normal_ACAGCTTTGCCG	Plasma
Normal_ACAGGCAGTCGC	Plasma
Normal_ACAGGCCCAGGT	Plasma
Normal_ACAGGTTCTCTC	Plasma
Normal_ACAGTATCTCCT	Plasma
Normal_ACAGTTGGTTAT	CD4Memory
Normal_ACATAGTTGTCT	Plasma
Normal_ACATATAGCCGC	Plasma
Normal_ACATCCATATCC	Plasma
Normal_ACATGCACTATC	Plasma
Normal_ACATGGAGGATT	HSPC
Normal_ACATGTTTTGGG	HSPC
Normal_ACATTGCAGTTA	cDC
Normal_ACATTGGCGCTA	Plasma
Normal_ACCAACCTGTAG	Plasma
Normal_ACCAAGTATATT	Plasma
Normal_ACCAATCGGCAC	cDC
Normal_ACCAATGACGTC	Plasma
Normal_ACCACATGTGTC	Plasma
Normal_ACCACGGCTGGC	Plasma
Normal_ACCACTGTGCTA	cDC
Normal_ACCAGCGCATAC	Plasma
Normal_ACCAGTTCCGGG	Plasma
Normal_ACCATCATGGCT	Plasma
Normal_ACCCAAATTACC	cDC
Normal_ACCCAGTACCAC	CD4Memory
Normal_ACCCATTGGCAG	Plasma
Normal_ACCCGCCCCTAC	Plasma
Normal_ACCCGGCCTACG	HSPC
Normal_ACCCTAACCACT	pDC
Normal_ACCGACATTTCG	Plasma
Normal_ACCGAGAAAAGT	Plasma
Normal_ACCGAGGGTAAG	cDC
Normal_ACCGATTTTGAT	Plasma
Normal_ACCGCTCCTGGG	HSPC
Normal_ACCGCTTAAACG	Plasma
Normal_ACCGGAGCCCGA	Plasma
Normal_ACCGGGCGTTGA	Plasma
Normal_ACCGGGTTTTCG	Plasma
Normal_ACCGGTTCTTAG	CD4Memory
Normal_ACCGTAGCATAT	HSPC
Normal_ACCGTTTCATGT	HSPC
Normal_ACCGTTTGCGCA	CD8Memory
Normal_ACCTAAAGGGTC	Plasma
Normal_ACCTATCTATAT	cDC
Normal_ACCTATGTTGCT	Plasma
Normal_ACCTCGCAATAT	cDC
Normal_ACCTGTTCCATC	Plasma
Normal_ACCTTATTTGAT	Plasma
Normal_ACCTTCTACGAA	Plasma
Normal_ACCTTGTTTCAG	HSPC
Normal_ACCTTTAGGCGG	cDC
Normal_ACGAACGAGTCG	Plasma
Normal_ACGACAAGCATT	Plasma
Normal_ACGACACGTGAG	Plasma
Normal_ACGACGATTGTC	CD4Memory
Normal_ACGACGCACTCA	Plasma
Normal_ACGAGCACACGG	Plasma
Normal_ACGAGCGCCGAC	Plasma
Normal_ACGAGCTCCGCT	Plasma
Normal_ACGAGGCTATTA	HSPC
Normal_ACGATGAAAACT	Plasma
Normal_ACGCAAGGGTCG	Plasma
Normal_ACGCAAGTTCAC	HSPC
Normal_ACGCAATCGGCA	CD8Memory
Normal_ACGCCATCAAAG	CD4Memory
Normal_ACGCCCAGTTGT	Plasma
Normal_ACGCGACCCTGC	Plasma
Normal_ACGCGAGCCTAG	CD4Memory
Normal_ACGCGGCCGCTG	Plasma
Normal_ACGCTCGTCATA	HSPC
Normal_ACGCTTCGAATA	Plasma
Normal_ACGGAGGCCGCA	Plasma
Normal_ACGGATTCATCC	Plasma
Normal_ACGGCGCTACGT	Plasma
Normal_ACGGCGCTTTAG	Plasma
Normal_ACGGGAATTATT	cDC
Normal_ACGGGACGGACC	Plasma
Normal_ACGGGGAGCGTA	Plasma
Normal_ACGGGGAGGTTG	Plasma
Normal_ACGGGTTCTTCG	Plasma
Normal_ACGGTATCTCCA	Plasma
Normal_ACGGTATTCTCC	Plasma
Normal_ACGGTCCTCGCT	Plasma
Normal_ACGGTCTGAAAA	HSPC
Normal_ACGGTGGCCCGA	Plasma
Normal_ACGGTTATCCTT	Plasma
Normal_ACGTACCCTTCG	Plasma
Normal_ACGTACCTGCCG	CD4Memory
Normal_ACGTACGGGAGT	Plasma
Normal_ACGTAGCACTGT	Plasma
Normal_ACGTCCATATAC	CD4Memory
Normal_ACGTCCCTTCTA	HSPC
Normal_ACGTCTAGGGGT	Plasma
Normal_ACGTCTGGACGG	cDC
Normal_ACTAAAAAAATG	Plasma
Normal_ACTAAAGCCAAT	Plasma
Normal_ACTAACCCCTGC	Plasma
Normal_ACTAATAGCCCA	Plasma
Normal_ACTACACGTCGT	HSPC
Normal_ACTACCCAAGGT	Plasma
Normal_ACTACCGACGGG	Plasma
Normal_ACTACGACCCCC	cDC
Normal_ACTACGATGAAT	Plasma
Normal_ACTACTATAGCG	HSPC
Normal_ACTACTCGAAAA	HSPC
Normal_ACTAGGGGTTCT	Plasma
Normal_ACTAGGTAGAGC	Plasma
Normal_ACTATCCGGCTC	HSPC
Normal_ACTCCATAACCC	Plasma
Normal_ACTCCCACCAGT	Plasma
Normal_ACTCCCCGCGCG	CD4Memory
Normal_ACTCGACTAGGC	Plasma
Normal_ACTCGTGGGGAG	Plasma
Normal_ACTCGTTGACTG	Plasma
Normal_ACTCTGCATTGG	Plasma
Normal_ACTGAGGAGTGG	Plasma
Normal_ACTGATGCCACG	HSPC
Normal_ACTGATTAAACT	Plasma
Normal_ACTGGAACGAGA	HSPC
Normal_ACTGTAGCACTC	Plasma
Normal_ACTGTTCCACTA	Plasma
Normal_ACTTACCCAAGT	Plasma
Normal_ACTTACTTCACC	Plasma
Normal_ACTTAGAACCAC	Plasma
Normal_ACTTCACTTCAC	Plasma
Normal_ACTTCGGAATCA	Plasma
Normal_ACTTCGTCTTCA	Plasma
Normal_ACTTCTGCGAGG	cDC
Normal_ACTTGCGGCAGG	cDC
Normal_ACTTGGTTAATA	Plasma
Normal_ACTTGTAAAAGC	Mono
Normal_ACTTGTTTGCGA	Plasma
Normal_ACTTTACCGAAT	CD4Memory
Normal_ACTTTGGTCATA	Plasma
Normal_AGAAAGATAGGT	cDC
Normal_AGAAAGCACTTT	Plasma
Normal_AGAAAGCCGGAT	Plasma
Normal_AGAAAGGACTAC	Plasma
Normal_AGAAAGGTTGGA	HSPC
Normal_AGAACGAAGAAC	CD4Memory
Normal_AGAACTAAAATA	Plasma
Normal_AGAAGCCTACTA	HSPC
Normal_AGAATCCTTTGG	Plasma
Normal_AGAATTCGCTAG	Plasma
Normal_AGAATTTTCGGT	Plasma
Normal_AGACATTGAATT	cDC
Normal_AGACCGAGACTT	Plasma
Normal_AGACCGCAAACA	HSPC
Normal_AGACTCATTTTC	Plasma
Normal_AGACTGCAGTAT	Plasma
Normal_AGACTTTACGGC	CD4Memory
Normal_AGAGACGTGGAG	Plasma
Normal_AGAGGAACTCTT	cDC
Normal_AGAGGACCCCTA	Plasma
Normal_AGAGGCGAGGCG	Plasma
Normal_AGAGGTTACATA	Plasma
Normal_AGAGGTTGAAAT	Plasma
Normal_AGAGTATAGACG	Plasma
Normal_AGAGTCAGACCT	Plasma
Normal_AGAGTCAGGGTG	Plasma
Normal_AGAGTGTTAATG	cDC
Normal_AGAGTTGGAACC	HSPC
Normal_AGAGTTGGCCGC	Plasma
Normal_AGATCCCAGCAA	cDC
Normal_AGATCCTAATTG	pDC
Normal_AGATCTCCACTG	CD4Memory
Normal_AGATGACGTATT	Plasma
Normal_AGATGGAGGGTG	Plasma
Normal_AGATTGGAACCA	cDC
Normal_AGCAATGAGTAA	Plasma
Normal_AGCACCGGAAGA	HSPC
Normal_AGCACTAGAAGA	HSPC
Normal_AGCAGATCCTAT	Plasma
Normal_AGCAGCAGGGTC	HSPC
Normal_AGCAGGGGCTTG	HSPC
Normal_AGCAGGTTCGTC	Plasma
Normal_AGCATCAGCCCG	CD8TermExh
Normal_AGCATCTTAGGA	cDC
Normal_AGCATGACGGCC	Plasma
Normal_AGCATGCACAAC	Plasma
Normal_AGCATGCGAAAC	Plasma
Normal_AGCATGGATCGT	Plasma
Normal_AGCCACAGGTCA	Plasma
Normal_AGCCAGCCATCA	Plasma
Normal_AGCCATTTCTTC	HSPC
Normal_AGCCCACACGCA	Plasma
Normal_AGCCCATACAGT	Plasma
Normal_AGCCGAGCCCGC	CD4Memory
Normal_AGCCGCGCAGAG	CD8TermExh
Normal_AGCCGTGTGCTG	HSPC
Normal_AGCCGTGTTGTC	Plasma
Normal_AGCGATCGTCGT	Plasma
Normal_AGCGCCATTTTA	Plasma
Normal_AGCGCTGAACGT	Plasma
Normal_AGCGGAGCTCGG	Plasma
Normal_AGCGGCTCAGCT	Plasma
Normal_AGCGGTATCATA	Plasma
Normal_AGCGGTGTCTAC	Plasma
Normal_AGCGTACGACCA	CD4Memory
Normal_AGCTAACTATAA	Plasma
Normal_AGCTAAGTATCG	Plasma
Normal_AGCTACCGTGAG	cDC
Normal_AGCTCTTACGAC	HSPC
Normal_AGCTGGTAAGGA	HSPC
Normal_AGCTTATAATAG	Plasma
Normal_AGCTTTTGACCC	Plasma
Normal_AGGAAAATGTCG	Plasma
Normal_AGGACTAAGCAA	Plasma
Normal_AGGACTCACTTC	Plasma
Normal_AGGACTCCGTGC	Plasma
Normal_AGGACTCTCTCC	Plasma
Normal_AGGACTGAAAAT	Plasma
Normal_AGGAGCGCCCGG	Plasma
Normal_AGGAGCGGGCCC	Plasma
Normal_AGGAGGGCGCTG	Plasma
Normal_AGGAGGGGATAG	Plasma
Normal_AGGAGTCCATGT	Plasma
Normal_AGGATCATCCAT	Plasma
Normal_AGGATCCGTATC	Plasma
Normal_AGGATGTTATCA	Plasma
Normal_AGGATGTTGGCC	Plasma
Normal_AGGATTTAGGAA	HSPC
Normal_AGGCACCAACGA	cDC
Normal_AGGCACCGTTTC	Plasma
Normal_AGGCCAAAAAGG	HSPC
Normal_AGGCCATAGGAT	Plasma
Normal_AGGCCCAATCCG	Plasma
Normal_AGGCCTAGGGCG	HSPC
Normal_AGGCGACCGGAA	Plasma
Normal_AGGCGCAGTGTC	Plasma
Normal_AGGCGCCCGCTA	Plasma
Normal_AGGCGTGTTCCG	CD8Naive
Normal_AGGCGTTACCTG	Plasma
Normal_AGGCTAGCTACA	Plasma
Normal_AGGCTATGTTCC	HSPC
Normal_AGGCTCATTAGA	Plasma
Normal_AGGCTCTACGTC	CD4Memory
Normal_AGGCTGCCGCCG	Plasma
Normal_AGGGAAAGTTGT	CD8TermExh
Normal_AGGGACGAAACT	Plasma
Normal_AGGGCAAAAGAG	Plasma
Normal_AGGGCCATAGGG	Plasma
Normal_AGGGCCCCCGAT	Plasma
Normal_AGGGCTGTGACA	Plasma
Normal_AGGGCTTATACG	Plasma
Normal_AGGGGCACGGGA	Plasma
Normal_AGGGGCAGGTCA	Plasma
Normal_AGGGGGCAAATA	cDC
Normal_AGGGTCACCCGG	Plasma
Normal_AGGGTCCTTGTC	Plasma
Normal_AGGGTGGATTAC	Plasma
Normal_AGGGTGTCACGA	Plasma
Normal_AGGGTGTTGTTG	Plasma
Normal_AGGGTTAAACAC	CD8TermExh
Normal_AGGTAGCCCCTA	Plasma
Normal_AGGTCTGACTGA	Plasma
Normal_AGGTGGGTTCGT	Plasma
Normal_AGGTGTCTAAGC	Plasma
Normal_AGGTTCACGACA	Plasma
Normal_AGGTTGAATGAC	CD4Memory
Normal_AGGTTGGGCAAA	Plasma
Normal_AGGTTTGATCTC	Plasma
Normal_AGTACGGAGAAG	Plasma
Normal_AGTACGGCTTTG	HSPC
Normal_AGTACTGGGCCA	Plasma
Normal_AGTACTGTCACG	Plasma
Normal_AGTAGACTGAGG	Plasma
Normal_AGTATTCTTAGC	cDC
Normal_AGTCAAAGTTGC	Plasma
Normal_AGTCAACCCTAT	Plasma
Normal_AGTCATTCGGAC	HSPC
Normal_AGTCCAACTGGT	Plasma
Normal_AGTCCCGGGACA	HSPC
Normal_AGTCCGGTCTAA	Plasma
Normal_AGTCCTGCTTGA	Plasma
Normal_AGTCCTTGATCC	CD8TermExh
Normal_AGTCGAAAAACG	Plasma
Normal_AGTCGCGGCATC	Plasma
Normal_AGTCTTGACTTT	Plasma
Normal_AGTCTTTCACCC	Plasma
Normal_AGTCTTTGTTCC	Plasma
Normal_AGTGCAACTTTA	Plasma
Normal_AGTGCGGGACGT	cDC
Normal_AGTGGGATGCCC	Plasma
Normal_AGTGGGGACTTC	CD4Memory
Normal_AGTGGGTTAGCA	Plasma
Normal_AGTGTCACGGCA	Plasma
Normal_AGTGTCAGGGCC	Plasma
Normal_AGTGTCCATGCC	Plasma
Normal_AGTGTGCAGCGC	CD4Memory
Normal_AGTGTTGTCAAA	Plasma
Normal_AGTGTTTCAAGA	Plasma
Normal_AGTTAAGAGTGG	Plasma
Normal_AGTTAGTCTACC	Plasma
Normal_AGTTCAGTTACA	cDC
Normal_AGTTCCGACCGT	HSPC
Normal_AGTTCCGGATGA	Plasma
Normal_AGTTCCTATCGT	Plasma
Normal_AGTTCTCGTGCG	CD4Memory
Normal_AGTTCTGGGCAG	Plasma
Normal_AGTTGAGGCACG	Plasma
Normal_AGTTGATTTATA	cDC
Normal_AGTTGCGACCGC	Plasma
Normal_AGTTGCGTTTCT	CD8TermExh
Normal_AGTTGTACTTAT	B
Normal_AGTTTAGATTCT	Plasma
Normal_AGTTTCATTTCT	Plasma
Normal_AGTTTGGCCTAG	Plasma
Normal_ATAAAAACTTAC	Plasma
Normal_ATAAAATTGGGC	Plasma
Normal_ATAAAGAGAGAT	pDC
Normal_ATAAATTCTGCT	Plasma
Normal_ATAACCATGAAT	Plasma
Normal_ATAACCTAACGG	Plasma
Normal_ATAAGCTTACTG	Plasma
Normal_ATAATACGCTCA	HSPC
Normal_ATAATAGTGCAA	Plasma
Normal_ATAATGAGTCGC	Plasma
Normal_ATAATGCCCAGA	Plasma
Normal_ATACAGTGCCTA	Plasma
Normal_ATACATGTAGGC	Plasma
Normal_ATACCATCTTCG	Plasma
Normal_ATACCGAGTCGC	Plasma
Normal_ATACCGCGAGCG	Plasma
Normal_ATACCTCGTTGG	Plasma
Normal_ATACGATATGCG	Plasma
Normal_ATACGCCATTCT	B
Normal_ATACGGCGATCC	cDC
Normal_ATACGTCTCGAT	Plasma
Normal_ATACTAATACGT	Plasma
Normal_ATACTACTATGT	HSPC
Normal_ATACTCAGATAT	Plasma
Normal_ATACTCCCTGCA	HSPC
Normal_ATACTGACTGCC	Plasma
Normal_ATACTTCCCGGT	Plasma
Normal_ATAGCGAGATCG	CD4Memory
Normal_ATAGCTATGCCC	Plasma
Normal_ATAGGATGCGCA	Plasma
Normal_ATAGGGATTTCG	cDC
Normal_ATAGGGTCTTGA	Plasma
Normal_ATAGTAGATCCT	HSPC
Normal_ATAGTAGCACTA	HSPC
Normal_ATAGTGCCAAAG	Plasma
Normal_ATAGTTAGGGCA	CD4Memory
Normal_ATATAAGGCTCG	cDC
Normal_ATATAGGATCGG	Plasma
Normal_ATATAGTCTTAT	Plasma
Normal_ATATCACGGGCA	Plasma
Normal_ATATCCAACTCA	Plasma
Normal_ATATCCGTGTTT	Plasma
Normal_ATATCGTGATCT	Plasma
Normal_ATATCTTTACAG	Plasma
Normal_ATATGGGCTGTC	Plasma
Normal_ATATTAGACTCA	Plasma
Normal_ATCAAGCTAGGT	CD4Memory
Normal_ATCAATAGACGC	Plasma
Normal_ATCAATCATTAG	CD4Memory
Normal_ATCACGGCCTGA	HSPC
Normal_ATCAGATGGACA	CD4Memory
Normal_ATCAGGTGGCTG	Plasma
Normal_ATCAGTGCAGCC	Plasma
Normal_ATCATAGAAGCG	cDC
Normal_ATCATGAACGAA	Plasma
Normal_ATCCACAGGGTC	Plasma
Normal_ATCCACGGCCTC	HSPC
Normal_ATCCACGTAACT	HSPC
Normal_ATCCAGCCGATG	CD4Memory
Normal_ATCCCCTCTTTT	CD8TermExh
Normal_ATCCCGTGTAAC	Plasma
Normal_ATCCGAATACGG	CD4Memory
Normal_ATCCGGCAAACT	CD4Memory
Normal_ATCCGGGAAACG	Plasma
Normal_ATCCGGGTGCGC	Plasma
Normal_ATCCGTAACCTG	CD8Memory
Normal_ATCCTAAATCTG	CD4Memory
Normal_ATCGAATGTGCG	Plasma
Normal_ATCGAGGTTTCG	Plasma
Normal_ATCGCAAGGCAA	CD4Memory
Normal_ATCGCGAATCAA	Plasma
Normal_ATCGGCACCTGC	Plasma
Normal_ATCGGTAGTCCC	cDC
Normal_ATCGGTATGGAC	Plasma
Normal_ATCGTATTGACC	NK
Normal_ATCGTTCAGCAG	B
Normal_ATCGTTCTAAAG	Plasma
Normal_ATCTCTCTCTGC	Plasma
Normal_ATCTGAAGGAAC	CD4Memory
Normal_ATCTGGGCATGG	Plasma
Normal_ATGAAACAAGCC	CD4Memory
Normal_ATGAAGACGTAC	Plasma
Normal_ATGAAGCATTAG	cDC
Normal_ATGAATAGGAAA	Plasma
Normal_ATGACGTAACGA	Plasma
Normal_ATGACGTAATGC	Plasma
Normal_ATGAGGCTCGAG	Plasma
Normal_ATGAGTATTCCC	Plasma
Normal_ATGAGTTCCACG	cDC
Normal_ATGATAAGTACC	Plasma
Normal_ATGATCTTTGTA	CD4Memory
Normal_ATGATGCTACCA	CD4Memory
Normal_ATGCAACCTTCG	HSPC
Normal_ATGCAAGGTTAG	CD4Memory
Normal_ATGCAATACGCC	cDC
Normal_ATGCACAAACTG	Plasma
Normal_ATGCACGGCAAC	Plasma
Normal_ATGCAGCCACCG	Plasma
Normal_ATGCCGGCGGGC	Plasma
Normal_ATGCCTGTCGTT	Mono
Normal_ATGCCTGTGAAG	HSPC
Normal_ATGCGAACAGTA	Plasma
Normal_ATGCGACCGCCA	Plasma
Normal_ATGCGAGCCTAA	Plasma
Normal_ATGCGAGCGAAC	cDC
Normal_ATGCTCCGCGCT	HSPC
Normal_ATGGAAAGCAGA	Plasma
Normal_ATGGAAATAGGA	Plasma
Normal_ATGGACATTATA	Plasma
Normal_ATGGCTCATCGC	Plasma
Normal_ATGGGCATATGT	Plasma
Normal_ATGGTTGTACTC	Plasma
Normal_ATGGTTTCAGTA	cDC
Normal_ATGTAAACTAAT	CD4Memory
Normal_ATGTAATAGAAC	Plasma
Normal_ATGTAGCATTTC	CD4Memory
Normal_ATGTCCGCAAAA	Plasma
Normal_ATGTCGGCGACA	HSPC
Normal_ATTAACCACCTG	B
Normal_ATTAATATCACC	Plasma
Normal_ATTAGCACCAAT	cDC
Normal_ATTATAGGGACA	Plasma
Normal_ATTATGATTTAG	Plasma
Normal_ATTATGTCCTGT	Plasma
Normal_ATTCAGCACCGG	CD4Memory
Normal_ATTCAGCGCGAC	Plasma
Normal_ATTCATGGCTTC	CD4Memory
Normal_ATTCCAAGTGAA	Plasma
Normal_ATTCGAGGCCTG	Plasma
Normal_ATTCGCATCGGC	HSPC
Normal_ATTCGGGCATCT	Plasma
Normal_ATTCTCCTGGAA	Plasma
Normal_ATTCTGAGTATT	Plasma
Normal_ATTGACATGATA	Plasma
Normal_ATTGACTAAATT	HSPC
Normal_ATTGCAGATTTT	Plasma
Normal_ATTGCAGTAGAT	CD4Memory
Normal_ATTGCTGTTCGA	Plasma
Normal_ATTGCTTCGGGG	Plasma
Normal_ATTGTCGGTGAT	Plasma
Normal_ATTGTCTTCATA	Plasma
Normal_ATTGTGACATCC	HSPC
Normal_ATTTAATCTTCG	Plasma
Normal_ATTTAATGCGGT	Plasma
Normal_ATTTACACTCAG	Plasma
Normal_ATTTAGCGTTAA	Plasma
Normal_ATTTAGCTAGCT	Plasma
Normal_ATTTAGTATTCA	cDC
Normal_ATTTATGCCGTT	Plasma
Normal_ATTTCACGATAC	Plasma
Normal_ATTTCATACTAA	Plasma
Normal_ATTTCCAAGTCG	Plasma
Normal_ATTTCCCAGAGG	HSPC
Normal_ATTTGGCATGCT	Plasma
Normal_ATTTGGGCAGAT	Plasma
Normal_ATTTGTAATTAT	Plasma
Normal_ATTTTAAAGATC	Plasma
Normal_ATTTTAAGATAA	Plasma
Normal_ATTTTACGAGTA	Plasma
Normal_ATTTTAGTCTTG	cDC
Normal_ATTTTATAAATA	cDC
Normal_ATTTTCAGGGGC	Plasma
Normal_ATTTTGGCTGAG	cDC
Normal_CAAAAATTTTGC	CD8Naive
Normal_CAAACGCGAAGG	Plasma
Normal_CAAACGCGGTGC	Plasma
Normal_CAAACGTTATAC	CD4Memory
Normal_CAAACTGCTTTG	Plasma
Normal_CAAACTTTTATT	Plasma
Normal_CAAAGCCGAAGA	cDC
Normal_CAAAGCGCCTTC	Plasma
Normal_CAAAGGACCCCT	B
Normal_CAAAGTAGGGCT	Plasma
Normal_CAAATCTCAGAA	Plasma
Normal_CAAATGCCCATC	Plasma
Normal_CAAATTAGGATG	Plasma
Normal_CAACACGAAGAA	Plasma
Normal_CAACACTCTTAT	Plasma
Normal_CAACAGCCCTAT	Plasma
Normal_CAACATCGATAA	Plasma
Normal_CAACATGTTCCT	Plasma
Normal_CAACATTAAAAG	Plasma
Normal_CAACCAAGAAAT	Plasma
Normal_CAACGATCGTAA	Plasma
Normal_CAACGATCTATG	cDC
Normal_CAACGCAACCCA	Plasma
Normal_CAACGCAGTATA	Plasma
Normal_CAACGCTCGCTT	Plasma
Normal_CAACGGCTACGG	Plasma
Normal_CAACGGGCTTTT	Plasma
Normal_CAACGGTACTTG	cDC
Normal_CAACGTACTACC	CD4Memory
Normal_CAACTAATAGTG	Plasma
Normal_CAAGATAATTGG	Plasma
Normal_CAAGCACGATGT	CD8Memory
Normal_CAAGCAGGCGAA	Plasma
Normal_CAAGCATGGGTC	Plasma
Normal_CAAGCCCGCTTA	Plasma
Normal_CAAGGAGACTTG	Plasma
Normal_CAAGGATTTACA	HSPC
Normal_CAAGTACCGCAG	Plasma
Normal_CAAGTAGACATA	Plasma
Normal_CAAGTCATCGGG	Plasma
Normal_CAAGTCGGTAGA	Plasma
Normal_CAATACGGCATC	Plasma
Normal_CAATAGGAGTAT	Plasma
Normal_CAATCCTTCTCA	Plasma
Normal_CAATCGAGCATA	CD8Naive
Normal_CAATCGCATCCA	Plasma
Normal_CAATGACGTGAT	Plasma
Normal_CAATGACTCAGC	Plasma
Normal_CAATGGACTCGC	Plasma
Normal_CAATGGCAGGCG	Plasma
Normal_CAATTGACTGCC	Plasma
Normal_CAATTTGACCAA	Plasma
Normal_CAATTTGCATGT	HSPC
Normal_CACAACAAAATA	pDC
Normal_CACAACCGGAAG	Plasma
Normal_CACAATAAAGAC	Plasma
Normal_CACACTCATTCG	Plasma
Normal_CACAGGTATACG	Plasma
Normal_CACATTAGAGCT	Plasma
Normal_CACCACGCTTTC	Plasma
Normal_CACCACGGTCAC	CD8TermExh
Normal_CACCGACACCTT	Plasma
Normal_CACCGAGCGTCG	Plasma
Normal_CACCGGAGCCAA	Plasma
Normal_CACCGTGCAATT	Plasma
Normal_CACCTAGGGTCC	HSPC
Normal_CACCTATTGGCC	Plasma
Normal_CACCTTGACTTG	Plasma
Normal_CACGAGACATGA	cDC
Normal_CACGCAAAAAGA	CD4Memory
Normal_CACGCGACTCAT	Plasma
Normal_CACGCGGTACTC	Plasma
Normal_CACGCTGCCCTA	Plasma
Normal_CACGGCATTCGA	cDC
Normal_CACGGGCCTCCA	Plasma
Normal_CACGTAGTCGTC	Plasma
Normal_CACGTCCCAGCC	cDC
Normal_CACGTGCCCGCT	Plasma
Normal_CACTAACCTGCA	Plasma
Normal_CACTAGTGTTGA	Plasma
Normal_CACTATACCCTC	Plasma
Normal_CACTATAGCTTC	HSPC
Normal_CACTCCGCTTCT	Plasma
Normal_CACTCTCGAGAG	Plasma
Normal_CACTGAAATCTG	Plasma
Normal_CACTGCACCCCA	Plasma
Normal_CACTGGAGGAAT	Plasma
Normal_CACTTCCCGCTT	Plasma
Normal_CAGAACATTCCT	Plasma
Normal_CAGAAGTAGTTT	cDC
Normal_CAGAATCGAGCC	Plasma
Normal_CAGACAGATTTC	Plasma
Normal_CAGACAGCCCCC	Plasma
Normal_CAGACATCAGTA	Plasma
Normal_CAGACCCTCACC	cDC
Normal_CAGACGATCGGC	CD4Memory
Normal_CAGACTTACTGA	Plasma
Normal_CAGAGCAGTGAG	Plasma
Normal_CAGAGGCGGAGC	Plasma
Normal_CAGAGGGAGATG	cDC
Normal_CAGAGTCTTAGG	HSPC
Normal_CAGATCACATAG	Plasma
Normal_CAGATGCAGGCC	HSPC
Normal_CAGATTAACTCG	CD8TermExh
Normal_CAGATTGCAATT	Plasma
Normal_CAGCAGTGCCTC	Plasma
Normal_CAGCATAGGGCT	Plasma
Normal_CAGCATATTGCA	Plasma
Normal_CAGCCAAGAGAC	Plasma
Normal_CAGCCATAATGC	Plasma
Normal_CAGCCTTAAGTC	cDC
Normal_CAGCGACATCGT	CD8Memory
Normal_CAGCGATGCGCT	cDC
Normal_CAGCTAGTTCAG	Plasma
Normal_CAGCTCCCTCGA	CD4Memory
Normal_CAGCTTCCACTA	CD8Memory
Normal_CAGCTTCTAATT	cDC
Normal_CAGGAGCTTAAC	HSPC
Normal_CAGGCCATACTA	HSPC
Normal_CAGGCTATGGAC	Plasma
Normal_CAGGCTCTTGTT	cDC
Normal_CAGGGTCTGCAG	Plasma
Normal_CAGGGTGTCTAC	Plasma
Normal_CAGGTTTTATCG	Plasma
Normal_CAGTAATGCATC	Plasma
Normal_CAGTACACCGCC	CD4Memory
Normal_CAGTACGGACTT	cDC
Normal_CAGTAGAGTCCA	Plasma
Normal_CAGTAGGCCTAT	CD8TermExh
Normal_CAGTCACGAACC	Plasma
Normal_CAGTGGAACCTC	HSPC
Normal_CAGTGTCGTCCG	Plasma
Normal_CAGTTAGTCCAT	CD4Memory
Normal_CAGTTGAAACTA	Plasma
Normal_CAGTTTTTACAT	HSPC
Normal_CATAACGTCAGT	Plasma
Normal_CATAACTCACAA	Plasma
Normal_CATAAGAACTAG	Plasma
Normal_CATAAGCCCCTA	CD8TermExh
Normal_CATAAGCGAGTT	Plasma
Normal_CATAAGTTTCAT	cDC
Normal_CATACATGGTAC	Plasma
Normal_CATACCATTCCT	CD4Memory
Normal_CATACTTCACCC	CD8Memory
Normal_CATAGACGAAAC	Plasma
Normal_CATAGCAACCAG	CD8Naive
Normal_CATAGGAGTTTC	Plasma
Normal_CATAGGCCTAGC	Plasma
Normal_CATATAAAGTAG	Plasma
Normal_CATATCACGTAT	CD4Memory
Normal_CATATCTTTAGT	Plasma
Normal_CATATGATCAAC	Plasma
Normal_CATCAAAACTAA	Plasma
Normal_CATCAGTAAACA	Plasma
Normal_CATCCACCTAAT	HSPC
Normal_CATCCATCCGTT	Plasma
Normal_CATCCCACTCAC	Plasma
Normal_CATCGAGTTTCG	Plasma
Normal_CATCGGAGTTTG	Plasma
Normal_CATCTCGGTTGA	Plasma
Normal_CATGATGATAGC	Plasma
Normal_CATGATGTCGTG	Plasma
Normal_CATGATTGCACA	Plasma
Normal_CATGCGTAAGTG	Plasma
Normal_CATGCTCCCAAG	HSPC
Normal_CATGGCGAGAAC	Plasma
Normal_CATGGGTAAATT	Plasma
Normal_CATGGTTTTAAA	Plasma
Normal_CATGTACAGCCC	Plasma
Normal_CATGTGACACGC	HSPC
Normal_CATGTTCAGTTT	HSPC
Normal_CATGTTGAAATC	Plasma
Normal_CATTAAGAGGAT	Plasma
Normal_CATTAAGAGTGT	Plasma
Normal_CATTATGAGTCG	Plasma
Normal_CATTCAAAGTAT	cDC
Normal_CATTCCTATGCA	Plasma
Normal_CATTCGAATGGA	Plasma
Normal_CATTCGATGAGG	Plasma
Normal_CATTCTGACGAG	Plasma
Normal_CATTCTTTGCCT	Plasma
Normal_CATTGAATTAGA	Plasma
Normal_CATTGACTAGGC	HSPC
Normal_CATTGCTAGATA	Plasma
Normal_CCAAACAGTTCT	Plasma
Normal_CCAAAGGCTTAT	Plasma
Normal_CCAAATAATAGG	CD4Memory
Normal_CCAACGCGTTTT	Plasma
Normal_CCAACGTACACG	Plasma
Normal_CCAAGCAAACGG	cDC
Normal_CCAAGCTAACCA	cDC
Normal_CCAAGCTACCAN	cDC
Normal_CCAAGGGTTAGT	Plasma
Normal_CCAATAACATAA	Plasma
Normal_CCAATTCTGCAT	CD8Memory
Normal_CCAATTGCTAAG	Plasma
Normal_CCACAAACCAGT	Plasma
Normal_CCACACTCACCC	Plasma
Normal_CCACCGGGTAAG	CD8TermExh
Normal_CCACCTAGTTTG	cDC
Normal_CCACCTCGCTAN	Mono
Normal_CCACCTTCGCTA	cDC
Normal_CCACTATCAATG	cDC
Normal_CCACTCATATTC	Plasma
Normal_CCACTTTCCGAA	Plasma
Normal_CCAGAGCGACAG	Plasma
Normal_CCAGATTGTCAC	Plasma
Normal_CCAGCACAGGCA	CD8Memory
Normal_CCAGCCACGAGG	Plasma
Normal_CCAGCGCTGCTC	cDC
Normal_CCAGGCATGGGA	Plasma
Normal_CCAGGCGGGCCT	Plasma
Normal_CCAGGGTGCGCC	Plasma
Normal_CCAGGTGGAAAC	Plasma
Normal_CCAGTAAATAAG	Plasma
Normal_CCAGTAGATGTA	Plasma
Normal_CCAGTTCCTATG	cDC
Normal_CCAGTTTCACGA	Plasma
Normal_CCATATCCGAAA	Plasma
Normal_CCATCGCCAGGG	Plasma
Normal_CCATCTTACTGT	CD4Memory
Normal_CCATGACTACGG	Plasma
Normal_CCATGGGCATGT	CD4Memory
Normal_CCATTACAAAAG	Plasma
Normal_CCATTCAGTGGG	HSPC
Normal_CCATTGCCGACC	Plasma
Normal_CCATTGGTAATT	Plasma
Normal_CCATTGGTGGAT	Plasma
Normal_CCCAAAATATCT	CD8TermExh
Normal_CCCAAATACTCC	HSPC
Normal_CCCAACACCCGT	Plasma
Normal_CCCAACTCGAGC	Plasma
Normal_CCCAACTTAAAG	Plasma
Normal_CCCAATACCAAA	Plasma
Normal_CCCAATGGGTAG	Plasma
Normal_CCCACATAGAGC	Plasma
Normal_CCCACATATGAA	cDC
Normal_CCCACGGGCTTT	HSPC
Normal_CCCACGTTAACT	Plasma
Normal_CCCACTAGCTGA	HSPC
Normal_CCCAGCCTGAGC	Plasma
Normal_CCCATAATTTCA	CD4Memory
Normal_CCCATAGTTCGC	Plasma
Normal_CCCATCGTATAA	Plasma
Normal_CCCATTAGTCTG	Plasma
Normal_CCCATTCCTTAT	Plasma
Normal_CCCCAAATCCGT	CD8Memory
Normal_CCCCACCATTTG	Plasma
Normal_CCCCATATATCT	Plasma
Normal_CCCCATTTGAGA	Plasma
Normal_CCCCCGAGCTGT	Plasma
Normal_CCCCCGTGAAAG	Plasma
Normal_CCCCGACCCGGC	HSPC
Normal_CCCCGACGGACA	Plasma
Normal_CCCCGCAGGCTT	Plasma
Normal_CCCCGTAAATAC	cDC
Normal_CCCCGTACGCGC	Plasma
Normal_CCCCTCGAATGG	Plasma
Normal_CCCCTCGTTGTA	cDC
Normal_CCCCTGCCAGTT	cDC
Normal_CCCCTTATAACC	HSPC
Normal_CCCGAAGTATGG	Plasma
Normal_CCCGACATCGAT	Plasma
Normal_CCCGACCCCTAG	Plasma
Normal_CCCGCACTTTAG	cDC
Normal_CCCGCCTCTTCC	Plasma
Normal_CCCGGATGAAAT	HSPC
Normal_CCCGGGAGCGAA	Plasma
Normal_CCCGGGCTTTGG	pDC
Normal_CCCGGGGCACTA	Plasma
Normal_CCCGTAATTCGT	HSPC
Normal_CCCGTCTGCTTT	Plasma
Normal_CCCGTGATTCTG	Plasma
Normal_CCCGTGCGGTAT	Plasma
Normal_CCCGTTTAAAAC	Plasma
Normal_CCCGTTTCATAG	CD8Memory
Normal_CCCTAATTGGGT	Plasma
Normal_CCCTATATGGGC	cDC
Normal_CCCTATTCAGGA	Plasma
Normal_CCCTCACCTATC	Plasma
Normal_CCCTCTTAACGG	cDC
Normal_CCCTCTTAATCG	Plasma
Normal_CCCTGATAAAAG	Plasma
Normal_CCCTGTATCAAA	Plasma
Normal_CCCTGTGTTTGA	cDC
Normal_CCCTTGATTAAC	Plasma
Normal_CCCTTGCCCCTT	HSPC
Normal_CCCTTGGGTGAT	CD4Memory
Normal_CCGAACCGGTTG	Plasma
Normal_CCGACAAGTATG	Plasma
Normal_CCGACACAATGC	Plasma
Normal_CCGACGTCGCCT	CD8TermExh
Normal_CCGACTTGAGTG	Plasma
Normal_CCGAGTCCAGCT	Plasma
Normal_CCGATTACCACT	CD4Memory
Normal_CCGCAAAGTGAG	Plasma
Normal_CCGCAATGTACT	Plasma
Normal_CCGCACTTTAGN	pDC
Normal_CCGCCACCCATA	HSPC
Normal_CCGCCCGAAGGG	Plasma
Normal_CCGCCGCGTCAC	Plasma
Normal_CCGCGACACATT	Plasma
Normal_CCGCTAAAGGAT	Plasma
Normal_CCGCTCGCATAC	Plasma
Normal_CCGCTGCCATCA	Plasma
Normal_CCGCTTTCCAAT	HSPC
Normal_CCGGACCCTTTT	Plasma
Normal_CCGGACCGGTAA	Plasma
Normal_CCGGATCGAGGC	CD8TermExh
Normal_CCGGCCCCACGA	Plasma
Normal_CCGGGCAAGATG	Plasma
Normal_CCGGGCATCTAA	Plasma
Normal_CCGGGCATTGCG	Plasma
Normal_CCGGTAATCTGT	Plasma
Normal_CCGGTGTCAGGC	Plasma
Normal_CCGTAAAGATGC	Plasma
Normal_CCGTACTAGAAT	Plasma
Normal_CCGTACTCATCT	Plasma
Normal_CCGTAGCTCAAA	Plasma
Normal_CCGTAGTCGCAT	Plasma
Normal_CCGTATATGTAG	HSPC
Normal_CCGTCGAGACAG	Plasma
Normal_CCGTCGCCCAGC	Plasma
Normal_CCGTCTGACATT	Plasma
Normal_CCGTCTTACTTA	HSPC
Normal_CCGTGACAAGTC	Plasma
Normal_CCGTGACGGGTC	Plasma
Normal_CCGTGCATATGT	CD4Memory
Normal_CCGTTGCGTACT	cDC
Normal_CCGTTTTCTCGT	Plasma
Normal_CCTAAACATCGG	Plasma
Normal_CCTAAGTAATAG	CD4Memory
Normal_CCTAATTGTGTA	Plasma
Normal_CCTAGAGAAGTA	cDC
Normal_CCTAGCGGCTAG	Plasma
Normal_CCTAGTGGAAAC	CD4Memory
Normal_CCTATCTATGCT	Plasma
Normal_CCTATTTAGCGT	cDC
Normal_CCTCAACTAAGA	Plasma
Normal_CCTCAATCCACC	Plasma
Normal_CCTCAGACCACA	HSPC
Normal_CCTCGGTCAAGG	Plasma
Normal_CCTCTGAGGTCT	Plasma
Normal_CCTCTTGACCTC	CD4Memory
Normal_CCTGAAAACAGG	Plasma
Normal_CCTGAAAGTCAC	HSPC
Normal_CCTGACGGGATG	Plasma
Normal_CCTGAGAATCCG	cDC
Normal_CCTGAGGAGGGC	Plasma
Normal_CCTGAGTATGTG	Plasma
Normal_CCTGATAATTCT	Plasma
Normal_CCTGATGTAAGA	Plasma
Normal_CCTGATTGATAG	cDC
Normal_CCTGCAAACGGT	cDC
Normal_CCTGCCGCGAGA	Plasma
Normal_CCTGCTTTCCGA	Plasma
Normal_CCTGGACCCGAG	CD8Memory
Normal_CCTGGCCACACT	Plasma
Normal_CCTGTCATCGTG	cDC
Normal_CCTGTCATGTAA	Plasma
Normal_CCTGTGCGCATG	Plasma
Normal_CCTGTTAACCTT	Plasma
Normal_CCTGTTGGTATA	Plasma
Normal_CCTTAACGATTA	HSPC
Normal_CCTTACGCGAAA	CD8TermExh
Normal_CCTTAGCACCCC	Plasma
Normal_CCTTCACAAGGA	HSPC
Normal_CCTTCCCCACAG	Plasma
Normal_CCTTCGCATATC	Plasma
Normal_CCTTGAAGGTTT	Plasma
Normal_CCTTGACCAAGT	cDC
Normal_CCTTTACCGAAC	Plasma
Normal_CCTTTGAGAACT	pDC
Normal_CCTTTGCAGCTC	Plasma
Normal_CCTTTGTCGGAG	HSPC
Normal_CGAAAAAATCCC	Plasma
Normal_CGAAACACTCTT	HSPC
Normal_CGAAACATCCTG	Plasma
Normal_CGAACAAACGGC	Plasma
Normal_CGAACGGACATG	HSPC
Normal_CGAACGGTAGGG	Plasma
Normal_CGAACTTCATGG	Plasma
Normal_CGAAGAAGGAAA	Plasma
Normal_CGAAGCCAAGGT	Plasma
Normal_CGAAGCGGTGGT	Plasma
Normal_CGAAGGGCAGCA	Plasma
Normal_CGAAGGTACTTC	Plasma
Normal_CGAAGGTCCGGT	Plasma
Normal_CGAAGTATGCTA	GammaDeltaLike
Normal_CGAAGTATTGAT	CD4Memory
Normal_CGAAGTTCTTCC	HSPC
Normal_CGAATCATCGCC	Plasma
Normal_CGACAGCACTTT	Plasma
Normal_CGACATTTACGT	cDC
Normal_CGACCAGTGGCG	HSPC
Normal_CGACCTCGGAAC	HSPC
Normal_CGACGGTCAACC	Plasma
Normal_CGACGTAAACTG	CD4Memory
Normal_CGACTTCCAGCG	cDC
Normal_CGACTTCTTCCT	Plasma
Normal_CGAGATATCGTA	cDC
Normal_CGAGCGCTCGCT	Plasma
Normal_CGAGGTGCTCGG	CD8TermExh
Normal_CGATAATTGGAG	Plasma
Normal_CGATACGGTGAT	HSPC
Normal_CGATACTTCATA	Plasma
Normal_CGATAGGAACAT	HSPC
Normal_CGATCATACACT	Plasma
Normal_CGATCGAGCTCA	Plasma
Normal_CGATGAAGGGGA	Plasma
Normal_CGATGCAGAACA	Plasma
Normal_CGATGGGCAGGA	cDC
Normal_CGATGTGGCCTG	Plasma
Normal_CGATGTGTGCGA	Plasma
Normal_CGATTCGGCAGA	CD4Memory
Normal_CGCAATTTAGAC	Plasma
Normal_CGCAGAAAAGCG	Plasma
Normal_CGCAGTCGGTCT	HSPC
Normal_CGCATACTAACA	CD8Memory
Normal_CGCATTGCTGGT	HSPC
Normal_CGCATTTCCCTA	Plasma
Normal_CGCCAAATCAAA	CD4Memory
Normal_CGCCAGCAAAAT	Plasma
Normal_CGCCAGTTCAGC	HSPC
Normal_CGCCCCAGTAAT	HSPC
Normal_CGCCCGCCCGAT	Plasma
Normal_CGCCCGGACCGG	HSPC
Normal_CGCCCGGGGCCG	HSPC
Normal_CGCCCGTAACTT	Plasma
Normal_CGCCGGCTCCTG	Plasma
Normal_CGCCGGTAGAAG	Plasma
Normal_CGCCGTATGTGA	Plasma
Normal_CGCCGTGGCCAG	cDC
Normal_CGCCTCGCCTTA	Plasma
Normal_CGCCTTTTTAAA	Plasma
Normal_CGCGATGATACT	cDC
Normal_CGCGCCTGCCCC	CD4Memory
Normal_CGCGCGGCAATA	CD4Memory
Normal_CGCGGCACATCA	CD4Memory
Normal_CGCGGTTACCGC	CD4Memory
Normal_CGCGTAGTGCCA	HSPC
Normal_CGCGTATGATAT	HSPC
Normal_CGCGTGCGGTGG	Plasma
Normal_CGCGTGGCCTGC	Plasma
Normal_CGCGTTAGGATC	Plasma
Normal_CGCTAAGCGTTC	Plasma
Normal_CGCTATCCCGCC	CD4Memory
Normal_CGCTATTTGCAG	Plasma
Normal_CGCTCTATGTGC	Plasma
Normal_CGCTGGTTGATA	Plasma
Normal_CGCTTCAGGAAC	Plasma
Normal_CGCTTTGTTATC	cDC
Normal_CGGAAGCTTGTT	Plasma
Normal_CGGAATGCACAG	Plasma
Normal_CGGAGTCCATCT	Plasma
Normal_CGGATGAGCATC	Plasma
Normal_CGGATGCTGGCC	Plasma
Normal_CGGCGCCGTCTC	cDC
Normal_CGGCGGACTGAG	Plasma
Normal_CGGCTAACAGAG	cDC
Normal_CGGCTATCCATT	Plasma
Normal_CGGCTCCCTATG	cDC
Normal_CGGGCACTGTCG	Plasma
Normal_CGGGCCGGGCGT	Plasma
Normal_CGGGCCTATCGA	Plasma
Normal_CGGGCGACCAAT	Plasma
Normal_CGGGGACCCGCA	CD4Memory
Normal_CGGGGCCACGTG	Plasma
Normal_CGGGGTTTGATA	Plasma
Normal_CGGTACCGAGAC	Plasma
Normal_CGGTAGCTCCTG	HSPC
Normal_CGGTAGTCGTCT	Plasma
Normal_CGGTCGGAAGAT	CD4Memory
Normal_CGGTCGGCCGTT	Plasma
Normal_CGGTGTCTATAG	Plasma
Normal_CGGTTGTACATC	CD4Memory
Normal_CGGTTTGCTACC	Plasma
Normal_CGTAAGGTCAAG	HSPC
Normal_CGTACCAGCTAA	Plasma
Normal_CGTACGCAACCC	Plasma
Normal_CGTACGTTACTC	Plasma
Normal_CGTAGGGAGACC	HSPC
Normal_CGTATAGTTCAG	Plasma
Normal_CGTATTTCGGAT	Plasma
Normal_CGTCACTTACAT	Plasma
Normal_CGTCAGCCGCGC	CD4Memory
Normal_CGTCAGTCAATT	HSPC
Normal_CGTCATAGACTC	NK
Normal_CGTCCGCCTTGC	Plasma
Normal_CGTCCGTACCCA	cDC
Normal_CGTCCTTTTGAG	Plasma
Normal_CGTCGCCGAGCG	Plasma
Normal_CGTCGTGAACTT	Plasma
Normal_CGTCTCATCCAT	Plasma
Normal_CGTCTTAGTACT	Plasma
Normal_CGTCTTCTACAT	Plasma
Normal_CGTCTTCTTTCA	CD8Memory
Normal_CGTGAAGGGATT	CD4Memory
Normal_CGTGAATACATG	Plasma
Normal_CGTGAGCTATGT	Plasma
Normal_CGTGAGGCACGA	Plasma
Normal_CGTGAGTCGATG	CD4Memory
Normal_CGTGCCCTGCAC	Plasma
Normal_CGTGGACACTCT	CD4Memory
Normal_CGTGGCCAATCC	Plasma
Normal_CGTGGCCATCCA	Plasma
Normal_CGTGGGTTGCAA	CD4Memory
Normal_CGTGTCAAGATA	Plasma
Normal_CGTGTGCATTCT	HSPC
Normal_CGTTAAAAGATG	Plasma
Normal_CGTTAACACCTG	Plasma
Normal_CGTTAACACTCA	Plasma
Normal_CGTTAACCTGGG	Plasma
Normal_CGTTAGAAAAGG	Plasma
Normal_CGTTAGTGGGCA	Plasma
Normal_CGTTATGACATC	Plasma
Normal_CGTTCAACACTC	CD4Memory
Normal_CGTTCCACTTGC	CD4Memory
Normal_CGTTCCAGTATG	cDC
Normal_CGTTCCATATGG	Plasma
Normal_CGTTCTCATCGG	Plasma
Normal_CGTTCTGCTTGG	Plasma
Normal_CGTTGATATCTA	cDC
Normal_CGTTGCAATCCG	Plasma
Normal_CGTTGCGGCCCT	Plasma
Normal_CGTTTAATGTAA	Plasma
Normal_CGTTTCATAAGG	Plasma
Normal_CGTTTCCGCATG	Plasma
Normal_CGTTTGCCAGGT	Plasma
Normal_CTAAAAATGCTT	Plasma
Normal_CTAAACATGTAG	CD4Memory
Normal_CTAAAGGTAAGC	CD4Memory
Normal_CTAAATGTACGT	Plasma
Normal_CTAACATACTCC	Plasma
Normal_CTAACGGAGTGA	HSPC
Normal_CTAACGGGCTCG	Plasma
Normal_CTAACGGTACTA	HSPC
Normal_CTAAGAAGAGAT	Plasma
Normal_CTAAGAAGGACG	Plasma
Normal_CTAATCCGGTCT	HSPC
Normal_CTAATCCTCTTA	Plasma
Normal_CTAATCTAAGCT	Plasma
Normal_CTAATGTACAAC	Plasma
Normal_CTAATGTCGGGC	Plasma
Normal_CTAATTCATTGC	HSPC
Normal_CTACAAAAACGC	Plasma
Normal_CTACCTAGCTGT	Plasma
Normal_CTACGCATCCCT	Plasma
Normal_CTACGGTAAGAC	HSPC
Normal_CTACTTGGCGTA	Plasma
Normal_CTAGAATGACTT	Plasma
Normal_CTAGAGGCACAT	Plasma
Normal_CTAGATACGCAT	Plasma
Normal_CTAGCAGCTAAA	Plasma
Normal_CTAGCCCGTTGA	Plasma
Normal_CTAGCGTGTGAG	Plasma
Normal_CTAGCTCTGTAG	HSPC
Normal_CTAGGGGGGGCG	CD4Memory
Normal_CTAGGTATCGGC	Plasma
Normal_CTAGTCATCCTC	Plasma
Normal_CTAGTCCTTTGT	cDC
Normal_CTAGTCGCTTAG	Plasma
Normal_CTAGTGAAAGAA	Plasma
Normal_CTATAAACCCCT	Plasma
Normal_CTATATGCCGCG	CD4Memory
Normal_CTATATTCTAGG	Plasma
Normal_CTATATTTTACT	Plasma
Normal_CTATCACTGGTG	Plasma
Normal_CTATCGTCCGGT	Plasma
Normal_CTATCTGGTGCC	Plasma
Normal_CTATCTGTTTAA	Plasma
Normal_CTATGACCGAAA	cDC
Normal_CTATGCGATCAT	Plasma
Normal_CTATGCTATTCG	Plasma
Normal_CTATGGCGTGAT	cDC
Normal_CTATGGGGAAGC	Plasma
Normal_CTATTCGGTTAT	Plasma
Normal_CTATTGCTACTA	Plasma
Normal_CTCACCAGAGTC	Plasma
Normal_CTCACGGGTAGA	cDC
Normal_CTCACGGTATGA	CD8TermExh
Normal_CTCACTTTGGAC	Plasma
Normal_CTCAGAGGAACA	CD4Memory
Normal_CTCAGTTGCTTT	Plasma
Normal_CTCATCATGGAT	Plasma
Normal_CTCATGCAGCTC	HSPC
Normal_CTCCACGACATC	cDC
Normal_CTCCAGAGATTC	HSPC
Normal_CTCCCCCCTACA	Plasma
Normal_CTCCCGACGTGT	Plasma
Normal_CTCCCTATGTCT	Plasma
Normal_CTCCCTCGAGAT	Plasma
Normal_CTCCGTAGCTTT	HSPC
Normal_CTCCGTGACCAT	HSPC
Normal_CTCCTATTTTAA	CD8TermExh
Normal_CTCCTCGTAGTG	Plasma
Normal_CTCCTCTCTCTG	HSPC
Normal_CTCCTGGGGGCC	cDC
Normal_CTCGGACAACCC	Plasma
Normal_CTCGGATGCTTG	cDC
Normal_CTCGGATTAGTC	Plasma
Normal_CTCGTCGCCCTC	Plasma
Normal_CTCGTTAGTGCT	Plasma
Normal_CTCTAAACGCAA	cDC
Normal_CTCTACAGGGAC	Plasma
Normal_CTCTACTCACCC	Plasma
Normal_CTCTAGGAGAGG	Plasma
Normal_CTCTAGGTCGAG	Plasma
Normal_CTCTGAGAAAAT	Plasma
Normal_CTCTGGACTCAA	Plasma
Normal_CTGAAATAGGGC	Plasma
Normal_CTGAACACTAGT	Plasma
Normal_CTGAATGCCACG	CD4Memory
Normal_CTGAATTACGGG	cDC
Normal_CTGACAATGCAT	Plasma
Normal_CTGACACCGTTG	Plasma
Normal_CTGACCCCAAGA	Plasma
Normal_CTGACCCGTGCT	CD4Memory
Normal_CTGAGGCCTAGC	cDC
Normal_CTGAGTGAAGCA	Plasma
Normal_CTGATAAAAAGC	Plasma
Normal_CTGATAAACAAG	Plasma
Normal_CTGATCAGAGTA	Plasma
Normal_CTGCAGACTTCA	Plasma
Normal_CTGCCAACACCC	Plasma
Normal_CTGCCACTTCAG	Plasma
Normal_CTGCCTCCTCCA	Plasma
Normal_CTGCGATTTGAC	Plasma
Normal_CTGCGGGCCCCT	HSPC
Normal_CTGCGTAGGATT	Plasma
Normal_CTGCTGGCAGAT	Plasma
Normal_CTGCTGTATTGG	Plasma
Normal_CTGCTTCACAGA	Plasma
Normal_CTGGACATTATC	Plasma
Normal_CTGGAGGGTAAT	Plasma
Normal_CTGGCCTGTCCG	Plasma
Normal_CTGGCGCGTAGG	Plasma
Normal_CTGGCGGCTCGC	Plasma
Normal_CTGGCTTTGATA	Plasma
Normal_CTGGTCTGGCTA	Plasma
Normal_CTGTACGCCGTC	HSPC
Normal_CTGTCAGAAAAG	Plasma
Normal_CTGTCGAGCTAT	Plasma
Normal_CTGTCGTTGCCT	Plasma
Normal_CTGTGCCACTCA	Plasma
Normal_CTGTGTATTACG	Plasma
Normal_CTGTTCTCGTAT	Plasma
Normal_CTGTTTCAAGGC	Plasma
Normal_CTGTTTTCTTTG	cDC
Normal_CTTAAAGTTTAA	Plasma
Normal_CTTAACGTCTGG	Plasma
Normal_CTTAAGGAGGCA	Plasma
Normal_CTTACGCATCGC	Plasma
Normal_CTTACTAGAGTA	CD4Memory
Normal_CTTAGAGTCATT	Plasma
Normal_CTTAGGAATGTG	Plasma
Normal_CTTAGGTGCCTC	Plasma
Normal_CTTATTAGATCA	Plasma
Normal_CTTCAAAGACGA	Plasma
Normal_CTTCCAGTGACT	Plasma
Normal_CTTCCAGTTTAG	CD4Memory
Normal_CTTCCGACAATG	Plasma
Normal_CTTCCGCCGATT	CD8TermExh
Normal_CTTCCGGGAGCT	Plasma
Normal_CTTCCTGAGTAT	Plasma
Normal_CTTCGCTTCCGA	Plasma
Normal_CTTCGGCTATTG	Plasma
Normal_CTTCGGGACACA	cDC
Normal_CTTCTCAGAGCA	Plasma
Normal_CTTCTCGCAGCA	Plasma
Normal_CTTCTTCCAGTG	Plasma
Normal_CTTGACGCGCCG	Plasma
Normal_CTTGAGATCATA	Plasma
Normal_CTTGATCCCGCG	HSPC
Normal_CTTGATGCTAAT	Plasma
Normal_CTTGCGTAACTT	Plasma
Normal_CTTGCGTAGGCT	cDC
Normal_CTTGCGTCTCGC	Plasma
Normal_CTTGCGTGCGAG	HSPC
Normal_CTTGCTGTACAA	Plasma
Normal_CTTGCTTACCTG	Plasma
Normal_CTTGGAGCCGGT	Plasma
Normal_CTTGGGCCAATT	Mono
Normal_CTTGTACTAGTG	Plasma
Normal_CTTGTTCCTCGA	Plasma
Normal_CTTGTTCTGCCG	Plasma
Normal_CTTTATCCGTGA	Plasma
Normal_CTTTCACGCACC	Plasma
Normal_CTTTCAGACGCT	Plasma
Normal_CTTTCATCGTAC	Plasma
Normal_CTTTCCTCGAGC	Plasma
Normal_CTTTCTTGCCAA	cDC
Normal_CTTTGAATTGAG	CD8TermExh
Normal_CTTTGACTATAC	Plasma
Normal_CTTTGAGCCGTA	Plasma
Normal_CTTTGCGAAGTG	Plasma
Normal_CTTTGGCCAGGA	Plasma
Normal_CTTTGTTTACTT	HSPC
Normal_CTTTTCAGTACC	Plasma
Normal_CTTTTCCGTTGC	Plasma
Normal_CTTTTGACCCAG	Plasma
Normal_CTTTTGTGTTAA	Plasma
Normal_CTTTTTAGAATT	Plasma
Normal_GAAACCCCCTAC	Plasma
Normal_GAAACCCTTCTC	Plasma
Normal_GAAACGTAAGAA	Plasma
Normal_GAAAGATGTGGT	Plasma
Normal_GAAAGGTGTTAA	HSPC
Normal_GAAATACCTATT	cDC
Normal_GAAATAGTGCTG	Plasma
Normal_GAAATGTCAACA	Plasma
Normal_GAAATTGGTACC	Plasma
Normal_GAACAAGAGAGT	Plasma
Normal_GAACAGGATTAA	Plasma
Normal_GAACCGGGTTGT	Plasma
Normal_GAACGAGATTCT	Plasma
Normal_GAACGTATACCG	cDC
Normal_GAACGTCACGCC	Plasma
Normal_GAACTGATCCTT	pDC
Normal_GAACTGGAACGC	Plasma
Normal_GAAGAGGGTGCA	Plasma
Normal_GAAGAGTCCCCT	Plasma
Normal_GAAGCTAGTCAC	Plasma
Normal_GAAGCTGCTGGC	Plasma
Normal_GAAGCTGTAGTA	HSPC
Normal_GAAGCTTACACA	HSPC
Normal_GAAGCTTGATTC	Plasma
Normal_GAAGGATCCATA	Plasma
Normal_GAAGGCAAGAGT	Plasma
Normal_GAAGGGCAGAAA	Plasma
Normal_GAAGTCCTACTC	HSPC
Normal_GAAGTCGACCCC	Plasma
Normal_GAAGTTTTTCCG	Plasma
Normal_GAATCTAGTTTC	Plasma
Normal_GAATGGAGCACG	Plasma
Normal_GAATTACACCCA	HSPC
Normal_GAATTCTGAGTG	Plasma
Normal_GACAAGCCAGAA	Plasma
Normal_GACAAGGAGCTG	CD4Memory
Normal_GACAATAGATTA	Plasma
Normal_GACACAATCAAC	HSPC
Normal_GACACAGTTGAG	Plasma
Normal_GACACGTTGACA	Plasma
Normal_GACAGAATAATA	HSPC
Normal_GACAGCTAGCCA	Plasma
Normal_GACAGCTCAGGG	Plasma
Normal_GACAGTCCGTCT	Plasma
Normal_GACAGTTGCTCC	Plasma
Normal_GACAGTTGTAAA	Plasma
Normal_GACATACTTGCT	Plasma
Normal_GACATCAGTCAC	Plasma
Normal_GACATGTGAGCT	CD4Memory
Normal_GACCAAACTACA	Plasma
Normal_GACCAAGAATTC	Plasma
Normal_GACCCGCAAGGG	CD4Memory
Normal_GACCCGTCAGTA	B
Normal_GACCCGTGTAGA	HSPC
Normal_GACCGCACTGAG	Plasma
Normal_GACCGGCGGGCA	Plasma
Normal_GACCGTGTACGC	Plasma
Normal_GACCTCTGAACG	Plasma
Normal_GACCTGCCGTGG	Plasma
Normal_GACGATTACGAA	CD4Memory
Normal_GACGCCACAAGT	Plasma
Normal_GACGCGAAGATA	Plasma
Normal_GACGGTTTTGAA	Plasma
Normal_GACGTCATCAAC	Plasma
Normal_GACGTGATAGAT	Plasma
Normal_GACTATATTAGC	cDC
Normal_GACTATCCCTGG	HSPC
Normal_GACTCACTACGT	Plasma
Normal_GACTCCGTTTCG	Plasma
Normal_GACTCGGCGTAC	Plasma
Normal_GACTGTTCCACG	Plasma
Normal_GACTGTTCGGGC	Plasma
Normal_GACTTTGCAAGA	Plasma
Normal_GACTTTGTTCTT	HSPC
Normal_GAGAAACCGTGA	HSPC
Normal_GAGAACGGTGAG	HSPC
Normal_GAGAAGGGGAGA	Plasma
Normal_GAGACTATTAAA	Plasma
Normal_GAGACTCTTAAT	Plasma
Normal_GAGAGACAAGAA	HSPC
Normal_GAGAGCGAGAAT	Plasma
Normal_GAGAGGCCTCCG	HSPC
Normal_GAGAGGGTGTAC	Plasma
Normal_GAGAGGTAGGCA	Plasma
Normal_GAGATCGCAATC	Plasma
Normal_GAGATGTTGCTC	Plasma
Normal_GAGCAAATGCTA	Plasma
Normal_GAGCCAAGGTCG	CD4Memory
Normal_GAGCCCACAGGC	Plasma
Normal_GAGCCCGGAAAT	Plasma
Normal_GAGCCGGTCCCC	Plasma
Normal_GAGCCGGTCGGG	Plasma
Normal_GAGCCGTTACAC	HSPC
Normal_GAGCCTACCTCA	CD4Memory
Normal_GAGCCTCTACCA	Plasma
Normal_GAGCCTTGTATG	Plasma
Normal_GAGCGAAGAGGC	HSPC
Normal_GAGCGGATCTTC	HSPC
Normal_GAGCGGTGCATG	Plasma
Normal_GAGCTTTTCGGC	Plasma
Normal_GAGGAAAATATA	Plasma
Normal_GAGGAAACTAGC	Plasma
Normal_GAGGAAGTACAT	Plasma
Normal_GAGGACCAATCA	Plasma
Normal_GAGGCGTTTCGG	Plasma
Normal_GAGGCTAGAGCA	HSPC
Normal_GAGGCTCGATCC	CD4Memory
Normal_GAGGGACACGAT	HSPC
Normal_GAGGGCAAGACN	Plasma
Normal_GAGGGGGCCTGC	Plasma
Normal_GAGGGGGCTGTA	B
Normal_GAGGTCCGGACT	Plasma
Normal_GAGGTGGAATAG	Plasma
Normal_GAGGTTATTGAC	HSPC
Normal_GAGGTTCCAGGA	Plasma
Normal_GAGGTTGGCTTG	Plasma
Normal_GAGTAACGTCGT	HSPC
Normal_GAGTAATACCGG	HSPC
Normal_GAGTAGGGTGCG	Plasma
Normal_GAGTAGGTTATG	Plasma
Normal_GAGTCCTTCGGC	Plasma
Normal_GAGTCGGAACGA	HSPC
Normal_GAGTCGTCTGAG	Plasma
Normal_GAGTGATGGGGA	Plasma
Normal_GAGTTTGAACCC	Plasma
Normal_GAGTTTTAGAGA	Plasma
Normal_GAGTTTTATTTC	Plasma
Normal_GATAAACATTAC	CD4Memory
Normal_GATAACAGGCAC	Plasma
Normal_GATAACCGGTCG	Plasma
Normal_GATAATGTACCT	Plasma
Normal_GATACTCGCAGA	cDC
Normal_GATAGGGCCCGT	Plasma
Normal_GATAGTTTACTA	cDC
Normal_GATATCCACAAT	CD4Memory
Normal_GATCAAGCCTAC	Plasma
Normal_GATCATAGGTGT	Plasma
Normal_GATCCAATACCA	Plasma
Normal_GATCCCAGCCGC	cDC
Normal_GATCCCTTCTAC	Plasma
Normal_GATCCGAGTTTG	Plasma
Normal_GATCCGATAACG	Plasma
Normal_GATCGGAGGCTA	Plasma
Normal_GATCTTCATTGC	Plasma
Normal_GATCTTGGTAGA	cDC
Normal_GATGAAAGGCGG	Plasma
Normal_GATGACGGTAAG	HSPC
Normal_GATGACTACTCA	CD4Memory
Normal_GATGAGTAACTG	Plasma
Normal_GATGCACAGACA	CD8Naive
Normal_GATGCGAAGGAG	HSPC
Normal_GATGCTCCTGTG	Plasma
Normal_GATGGATCATAT	CD4Memory
Normal_GATGGCTAGAAG	Plasma
Normal_GATGGGTATGCT	Plasma
Normal_GATGTAGTGACT	Plasma
Normal_GATGTGCACACT	HSPC
Normal_GATTAAGGAAGA	Plasma
Normal_GATTCCCTGATT	Plasma
Normal_GATTCGGACCCA	Plasma
Normal_GATTCTTAGAGC	Plasma
Normal_GATTGACATACG	HSPC
Normal_GATTGCCTTTGA	Plasma
Normal_GATTGCGTGGAA	HSPC
Normal_GATTGGCTCAGG	Plasma
Normal_GATTGGGAAATC	Plasma
Normal_GATTGTGGCCTT	Plasma
Normal_GCAAAAGTTAAT	Plasma
Normal_GCAAACATTATC	Plasma
Normal_GCAACACGCTTC	cDC
Normal_GCAACGATACGC	Plasma
Normal_GCAACGCGGTTT	Plasma
Normal_GCAACTTAGTAC	Plasma
Normal_GCAAGAACTACG	Plasma
Normal_GCAAGCCTCAGA	Plasma
Normal_GCAAGCGCATAT	Plasma
Normal_GCAAGGTATTGC	Plasma
Normal_GCAAGTTTCGAT	cDC
Normal_GCAATCCCAGCG	Plasma
Normal_GCAATGATGAAG	HSPC
Normal_GCAATTGCCTGC	Plasma
Normal_GCACACACCCTC	Plasma
Normal_GCACACCGTCTA	Plasma
Normal_GCACAGCCAAGT	Plasma
Normal_GCACAGCGGGGT	Plasma
Normal_GCACAGGCACTT	Plasma
Normal_GCACAGTACAAT	Plasma
Normal_GCACATGTATGC	Plasma
Normal_GCACATTTGTCT	Plasma
Normal_GCACCAGAGTAA	cDC
Normal_GCACCCGCGGGA	HSPC
Normal_GCACCTCAAGAG	Plasma
Normal_GCACCTGAGATA	Plasma
Normal_GCACTAGTAGAA	HSPC
Normal_GCACTTCTCTAT	CD4Memory
Normal_GCAGCGGGTGAG	Plasma
Normal_GCAGGCACCCGG	Plasma
Normal_GCAGGGCGGATT	Plasma
Normal_GCAGTGGGAACG	Plasma
Normal_GCATCACACTCT	Plasma
Normal_GCATCCACCGTA	CD4Memory
Normal_GCATCGAAGCTA	Plasma
Normal_GCATCTAATTGG	pDC
Normal_GCATGGTTATCA	CD8Memory
Normal_GCATGTGGGGAG	Plasma
Normal_GCATTCGGGTCT	Plasma
Normal_GCCAAAGTAATG	Plasma
Normal_GCCACAGTGGTG	Plasma
Normal_GCCACATCGGAT	Plasma
Normal_GCCACCAGCGGT	Plasma
Normal_GCCACTATAACA	Plasma
Normal_GCCAGCAAAGGC	Plasma
Normal_GCCAGGCATACG	Plasma
Normal_GCCATCAGTGAA	Plasma
Normal_GCCATCCTTGTA	Plasma
Normal_GCCATCTCATAA	Plasma
Normal_GCCATTATATCT	Plasma
Normal_GCCCAAAGGCTA	Plasma
Normal_GCCCACAGCGAG	CD4Memory
Normal_GCCCGCGCCACT	Plasma
Normal_GCCCGTACAGTC	Plasma
Normal_GCCCTAGTCGAT	cDC
Normal_GCCGAAAGCAGC	Plasma
Normal_GCCGAAGACGCC	Plasma
Normal_GCCGATTCATCC	Plasma
Normal_GCCGCCTCACCG	HSPC
Normal_GCCGCTACTGAG	Plasma
Normal_GCCGCTAGGCTC	CD8Memory
Normal_GCCGGATCTAGA	cDC
Normal_GCCGGCTCAAGA	Plasma
Normal_GCCGGTGCGTGA	cDC
Normal_GCCGTCACAATG	CD4Memory
Normal_GCCGTCCGCTGA	Plasma
Normal_GCCTAAGTTGGC	Plasma
Normal_GCCTAGACAAAC	Plasma
Normal_GCCTGCCTCTTA	cDC
Normal_GCCTTATGACCC	cDC
Normal_GCGAAGGGGATC	cDC
Normal_GCGACGGATATC	Plasma
Normal_GCGACTCGGTGA	cDC
Normal_GCGACTTTTCCC	HSPC
Normal_GCGAGAGCCATC	Plasma
Normal_GCGAGATCTCGG	Plasma
Normal_GCGATGTAAAAG	Plasma
Normal_GCGATGTCCTAA	Plasma
Normal_GCGATGTGGCTC	CD4Memory
Normal_GCGATTTGAAAG	Plasma
Normal_GCGCAACACATA	HSPC
Normal_GCGCATATTATG	Plasma
Normal_GCGCATTGATCC	Plasma
Normal_GCGCCACTACAC	Plasma
Normal_GCGCGGCTACGG	CD4Memory
Normal_GCGCGGGGAAGT	Plasma
Normal_GCGCGGGTATAG	CD4Memory
Normal_GCGCGGGTGGTA	Plasma
Normal_GCGCTACAAGAT	Plasma
Normal_GCGCTCGCCTCA	Plasma
Normal_GCGCTTGGGCCC	cDC
Normal_GCGGAATAGTGT	cDC
Normal_GCGGAGTCGGTT	Plasma
Normal_GCGGCTGCTGTT	Plasma
Normal_GCGGGCAACTTA	HSPC
Normal_GCGGGCGATGAC	Plasma
Normal_GCGGGCTATACC	Plasma
Normal_GCGGGGTGAAGA	HSPC
Normal_GCGGGTCCATAG	Plasma
Normal_GCGGGTGTCTCA	cDC
Normal_GCGGTGCCGTGC	Plasma
Normal_GCGTAACTACTA	Plasma
Normal_GCGTAGCGCGTG	Plasma
Normal_GCGTATTACGAN	B
Normal_GCGTATTAGCGA	cDC
Normal_GCGTCCGCGCCG	CD4Memory
Normal_GCGTCGAGCAGT	Plasma
Normal_GCGTGACGAGCC	Plasma
Normal_GCGTGCAACGAT	Plasma
Normal_GCGTGCGCACGC	Plasma
Normal_GCGTGGGTCACA	Plasma
Normal_GCTAACTTAAGT	Plasma
Normal_GCTACAAGACCG	cDC
Normal_GCTACACCAATA	Plasma
Normal_GCTACCGCACCC	Plasma
Normal_GCTAGAACGTAT	Plasma
Normal_GCTAGAAGATAG	HSPC
Normal_GCTAGCATCGAC	cDC
Normal_GCTAGGCTATCG	HSPC
Normal_GCTATTCTAATT	HSPC
Normal_GCTCAAAGCTCT	Plasma
Normal_GCTCAATAACTT	Plasma
Normal_GCTCCACCGTAC	Plasma
Normal_GCTCCCATATGA	Plasma
Normal_GCTCCGACTTAA	ProB
Normal_GCTCCGGGCCGC	cDC
Normal_GCTCGCCCTTCA	HSPC
Normal_GCTCGGACTCGA	Plasma
Normal_GCTCTATCACTG	Plasma
Normal_GCTCTCCCATTA	cDC
Normal_GCTCTTATCATG	Plasma
Normal_GCTCTTCAGGCC	HSPC
Normal_GCTGACAGTCTA	Plasma
Normal_GCTGAGCCGAAA	Plasma
Normal_GCTGAGCTCCGG	HSPC
Normal_GCTGAGGAGATC	Plasma
Normal_GCTGAGTATTAA	cDC
Normal_GCTGATGGAAAG	CD4Memory
Normal_GCTGCTATTAGA	Plasma
Normal_GCTGGGGGTTGA	Plasma
Normal_GCTGGTTGGACC	Plasma
Normal_GCTGTACATGTT	Plasma
Normal_GCTGTCGAATAG	Plasma
Normal_GCTGTGGTTGTC	Plasma
Normal_GCTGTTAGCGAT	Plasma
Normal_GCTTATATTGCA	Plasma
Normal_GCTTCGCTACAA	cDC
Normal_GCTTCGGCTCTA	HSPC
Normal_GCTTCGTACATT	Plasma
Normal_GCTTGCATACGC	Plasma
Normal_GCTTGGTGCCGC	HSPC
Normal_GCTTGTGGACGG	CD8Memory
Normal_GCTTGTGGTCAG	HSPC
Normal_GCTTTAGGATCG	Plasma
Normal_GCTTTAGGCCCC	Plasma
Normal_GCTTTCTCCCTC	Plasma
Normal_GCTTTGCAGGGT	cDC
Normal_GGAAAGCCTTGC	Plasma
Normal_GGAAAGTACTAG	CD4Memory
Normal_GGAAAGTGTGCG	Plasma
Normal_GGAACCAGTTAA	cDC
Normal_GGAACCGAGTAG	cDC
Normal_GGAAGACCGAAG	Plasma
Normal_GGAATAAATTTA	CD4Memory
Normal_GGAATAATTATA	Plasma
Normal_GGAATATTTCGT	CD8TermExh
Normal_GGAATCAAGGGA	CD4Memory
Normal_GGAATGAGTTCC	Plasma
Normal_GGAATGCCGACT	Plasma
Normal_GGAATTCCTGGT	Plasma
Normal_GGAATTCGTTTT	Plasma
Normal_GGACAATCGCCT	Plasma
Normal_GGACAATGATAT	CD4Memory
Normal_GGACACAAGTTC	Plasma
Normal_GGACAGTCTACG	Plasma
Normal_GGACATCACCTA	Plasma
Normal_GGACCGCTTCCG	Plasma
Normal_GGACCGTCGCTC	Plasma
Normal_GGACCTTGCACC	CD4Memory
Normal_GGACGCCTTGCG	Plasma
Normal_GGACTAAGGGAA	Plasma
Normal_GGACTAGGTTAA	Plasma
Normal_GGACTCGAAGTC	HSPC
Normal_GGACTGCCGTTT	Plasma
Normal_GGACTGTCAAAT	CD4Memory
Normal_GGAGAAGATCGT	Plasma
Normal_GGAGAATGTTAT	Plasma
Normal_GGAGACCGAGAT	Plasma
Normal_GGAGCTGGCTGA	Plasma
Normal_GGAGGGCGCTCT	HSPC
Normal_GGAGGTCGTTAT	cDC
Normal_GGAGGTGTCAGA	Plasma
Normal_GGAGGTTGCACG	HSPC
Normal_GGAGTAAATTAT	Plasma
Normal_GGAGTCAGCGGA	cDC
Normal_GGAGTGCGATAA	Mono
Normal_GGAGTTGGAATG	Plasma
Normal_GGAGTTTCGAAC	CD8Memory
Normal_GGATAGCTTTCG	cDC
Normal_GGATAGGGTACA	Plasma
Normal_GGATCCTCCTAA	Plasma
Normal_GGATCGTAAACA	Plasma
Normal_GGATCGTCATAA	Plasma
Normal_GGATGACACGGC	Plasma
Normal_GGATGGGGGGGA	cDC
Normal_GGATGTATAAGC	Plasma
Normal_GGATTACTGCAC	Plasma
Normal_GGATTTATGGGC	Plasma
Normal_GGATTTGGTATA	Plasma
Normal_GGCAACAGAGGT	Plasma
Normal_GGCAATGAAGTT	B
Normal_GGCAGATTTGCG	Plasma
Normal_GGCAGCGCTTCC	Plasma
Normal_GGCAGGACTAAC	Plasma
Normal_GGCAGGCATTAG	Plasma
Normal_GGCAGGGGCGTC	Plasma
Normal_GGCAGTAATTAG	Plasma
Normal_GGCAGTGCACAA	cDC
Normal_GGCATACCTACA	Plasma
Normal_GGCATAGGTAAG	Plasma
Normal_GGCATGGGGACC	cDC
Normal_GGCCACATACGT	Plasma
Normal_GGCCACTGGTAT	HSPC
Normal_GGCCACTTACCT	Plasma
Normal_GGCCCAATCACT	Plasma
Normal_GGCCCGACAGGA	Plasma
Normal_GGCCGAGTAGTC	Plasma
Normal_GGCCGCGGCGGT	Plasma
Normal_GGCCGGGTGGAG	HSPC
Normal_GGCCTCCATCGA	HSPC
Normal_GGCCTCGATTCT	Plasma
Normal_GGCCTGAAAGCA	HSPC
Normal_GGCGAAGATCCT	Plasma
Normal_GGCGACCTCTGG	Plasma
Normal_GGCGCGTTAACC	Plasma
Normal_GGCGCTGGAACC	Plasma
Normal_GGCGGAGACACT	HSPC
Normal_GGCGGCCATTGC	cDC
Normal_GGCGGCGGAGCC	CD4Memory
Normal_GGCGGGAGGCTG	Plasma
Normal_GGCGTATACACA	Plasma
Normal_GGCGTCGTTGCC	Plasma
Normal_GGCGTGAATACA	Plasma
Normal_GGCGTTAGCCCC	cDC
Normal_GGCGTTATACCA	HSPC
Normal_GGCGTTTACCTA	Plasma
Normal_GGCTAACAGTTA	CD4Memory
Normal_GGCTAATGTGAG	Plasma
Normal_GGCTACTGCCCT	Plasma
Normal_GGCTAGGGTTAT	cDC
Normal_GGCTCATTTACA	Plasma
Normal_GGCTCCTGAGAG	cDC
Normal_GGCTCTAGAGGA	Plasma
Normal_GGCTGACAAACT	Plasma
Normal_GGCTGAGCCCCG	HSPC
Normal_GGCTGATGAACG	Plasma
Normal_GGCTGGTGAGGT	CD8Memory
Normal_GGCTTTGCCCGC	Plasma
Normal_GGGAACGCGCGT	Plasma
Normal_GGGAATGGGGGC	Plasma
Normal_GGGACACGGATC	HSPC
Normal_GGGACATCGGGC	CD8Memory
Normal_GGGACGAGCACA	CD4Memory
Normal_GGGACGGTTCTT	Plasma
Normal_GGGAGATCTACG	Plasma
Normal_GGGAGCAGATCA	HSPC
Normal_GGGAGGGGAAGG	CD4Memory
Normal_GGGATAAGTACA	Plasma
Normal_GGGATTATAGGT	Plasma
Normal_GGGATTTGTTGT	Plasma
Normal_GGGCAGGTTAAC	Plasma
Normal_GGGCCCAGATCG	Plasma
Normal_GGGCCGGATATA	Plasma
Normal_GGGCCTACATAG	Plasma
Normal_GGGCGGCTGTCA	B
Normal_GGGCTCCTTGGA	Plasma
Normal_GGGCTTCGCGGC	Plasma
Normal_GGGGAACATTAT	CD4Memory
Normal_GGGGATGACCTC	cDC
Normal_GGGGATTCCAAC	Plasma
Normal_GGGGCGGCCGGG	cDC
Normal_GGGGCGGGTTCA	Plasma
Normal_GGGGCGTACTAA	HSPC
Normal_GGGGGGAGTGCT	HSPC
Normal_GGGGGTTACACT	HSPC
Normal_GGGGGTTTCCAT	pDC
Normal_GGGGTGCCTTGA	Plasma
Normal_GGGGTGTGCCAT	CD4Memory
Normal_GGGGTTGTACTT	Plasma
Normal_GGGTACCCGAGA	Plasma
Normal_GGGTAGCCGGAA	HSPC
Normal_GGGTATCGGCAT	HSPC
Normal_GGGTCTGGGCAC	Plasma
Normal_GGGTCTTGGACA	Plasma
Normal_GGGTTAATGATG	pDC
Normal_GGTAACCTAGTC	HSPC
Normal_GGTAAGGTGTGT	HSPC
Normal_GGTAAGGTTTTC	HSPC
Normal_GGTAATCAGGTC	Plasma
Normal_GGTAATCATTGA	cDC
Normal_GGTACCTCCCGT	Plasma
Normal_GGTAGATGCCTC	HSPC
Normal_GGTAGCATCCTA	HSPC
Normal_GGTAGCATGGCT	HSPC
Normal_GGTAGGCGTGAA	Plasma
Normal_GGTAGGGCACGG	Plasma
Normal_GGTAGTACAGGC	Plasma
Normal_GGTATAGATTGC	Plasma
Normal_GGTATTAACAAC	Plasma
Normal_GGTCAATTGTCA	CD8TermExh
Normal_GGTCACCAACTC	CD8Memory
Normal_GGTCACCGGAGT	Plasma
Normal_GGTCATCCAGGG	Plasma
Normal_GGTCCAGGAGTG	Plasma
Normal_GGTCCGCATTCA	Plasma
Normal_GGTCCGGGGCCC	Plasma
Normal_GGTCGACTGACA	HSPC
Normal_GGTCGAGAAGGT	Plasma
Normal_GGTCGCTCTCAC	CD4Memory
Normal_GGTCGTACTCCA	pDC
Normal_GGTCTAACCCCC	Plasma
Normal_GGTCTACAATTC	CD4Memory
Normal_GGTCTCTCTAGG	Plasma
Normal_GGTCTGTTATCT	GammaDeltaLike
Normal_GGTGAAGACAGG	HSPC
Normal_GGTGAATCAATG	Plasma
Normal_GGTGACACTGAG	CD8Naive
Normal_GGTGACCTCACT	Plasma
Normal_GGTGATATCCGC	HSPC
Normal_GGTGCCCATACA	Plasma
Normal_GGTGCGGTTATC	Plasma
Normal_GGTGGAACCGTG	Plasma
Normal_GGTGGAGCTCTG	Plasma
Normal_GGTGGGCACAAA	Plasma
Normal_GGTGTGTCTGCA	CD4Memory
Normal_GGTGTGTTGGCG	Plasma
Normal_GGTGTTACTTGC	Plasma
Normal_GGTTAACTGTAT	CD4Memory
Normal_GGTTAATACGTA	Plasma
Normal_GGTTACAACCAT	Plasma
Normal_GGTTACGCAGAC	Plasma
Normal_GGTTATAGCACG	CD8TermExh
Normal_GGTTATGAAGCC	CD4Memory
Normal_GGTTATGATCGG	Plasma
Normal_GGTTCAAACTTA	Plasma
Normal_GGTTCACTGTGG	Plasma
Normal_GGTTCCAATCTT	Plasma
Normal_GGTTCCCAGGTC	Plasma
Normal_GGTTCCTAACGG	cDC
Normal_GGTTCCTTCTCG	cDC
Normal_GGTTCTCAAGTA	Plasma
Normal_GGTTGGATATCC	Plasma
Normal_GGTTGGCTCACC	CD4Memory
Normal_GGTTTAAGACAC	HSPC
Normal_GGTTTCTACTCC	Plasma
Normal_GGTTTGTTCGGT	pDC
Normal_GTAAAATTGGAG	Plasma
Normal_GTAACTAAACCC	Plasma
Normal_GTAACTCCAAGA	Plasma
Normal_GTAAGATGTGAG	CD4Memory
Normal_GTAAGCTCAGCG	Plasma
Normal_GTAAGGATCAAC	Plasma
Normal_GTAAGGTTCTTA	Plasma
Normal_GTAAGTCGGAAT	Plasma
Normal_GTAAGTGGGCTT	HSPC
Normal_GTAATAAATTCT	Plasma
Normal_GTAATATCGTTC	Plasma
Normal_GTAATGACGGTC	HSPC
Normal_GTAATGAGACCG	cDC
Normal_GTAATTTCGCCT	Plasma
Normal_GTACATTTAGGA	Plasma
Normal_GTACCGTTACAA	Plasma
Normal_GTACCTTGGAAC	Plasma
Normal_GTACGGATACCA	HSPC
Normal_GTACGTTCTAGC	Plasma
Normal_GTACTTCCCAGG	Plasma
Normal_GTACTTTAGCGG	Plasma
Normal_GTAGCAGCCGGC	cDC
Normal_GTAGCGACCCTA	Plasma
Normal_GTAGCTCACTTG	CD4Memory
Normal_GTAGGCCTTCAG	Plasma
Normal_GTAGGTGGCTAA	Plasma
Normal_GTAGGTTAATCC	Plasma
Normal_GTAGTAATCCAG	Plasma
Normal_GTAGTACGCGAC	CD8Memory
Normal_GTAGTACTCTGG	cDC
Normal_GTAGTCAGTCGC	cDC
Normal_GTAGTTGTTCTA	Plasma
Normal_GTAGTTTTCTGT	Plasma
Normal_GTATAAGAGATT	Plasma
Normal_GTATACGCCAGC	CD4Memory
Normal_GTATACGTAGAC	CD4Memory
Normal_GTATAGTAGGAT	Plasma
Normal_GTATCAACAAAA	Plasma
Normal_GTATCAGACTGN	Plasma
Normal_GTATCCTCGGAT	Plasma
Normal_GTATGCCACGTC	Plasma
Normal_GTATTGCCGCCC	Plasma
Normal_GTCAATAAGTGT	Plasma
Normal_GTCACCCCGTCA	Plasma
Normal_GTCAGCCAGTAG	Mono
Normal_GTCAGGAAGGCC	CD8Memory
Normal_GTCAGGGTAGTG	Plasma
Normal_GTCAGTCCGGCC	CD4Memory
Normal_GTCATCGCTTTT	HSPC
Normal_GTCATCTGAGGA	cDC
Normal_GTCATGGAATTC	Plasma
Normal_GTCATTTTATCC	Plasma
Normal_GTCCACAGTTCG	Plasma
Normal_GTCCCACCCCGG	Plasma
Normal_GTCCCCGATCCG	Plasma
Normal_GTCCCGGCTCAT	Plasma
Normal_GTCCGTACGATC	HSPC
Normal_GTCCGTAGTGCC	Plasma
Normal_GTCCTGACCAAC	Plasma
Normal_GTCCTGTAGACA	Plasma
Normal_GTCCTTGCTCCT	CD4Memory
Normal_GTCGATGGATTC	Plasma
Normal_GTCGCAACAATG	cDC
Normal_GTCGCGAGGGTT	Plasma
Normal_GTCGCTCATAGT	Plasma
Normal_GTCGGAGTGTTC	HSPC
Normal_GTCGGGACACGA	Plasma
Normal_GTCGGGATGCGG	Plasma
Normal_GTCGTCCAATAC	pDC
Normal_GTCTAGGTCTTT	Plasma
Normal_GTCTATTAAGCA	Plasma
Normal_GTCTCAAGAGAT	Plasma
Normal_GTCTCGAGCCAG	Plasma
Normal_GTCTGTGTATGC	CD8Memory
Normal_GTCTTCTCACGT	Plasma
Normal_GTCTTTTATTAC	Plasma
Normal_GTGAACATTGAG	HSPC
Normal_GTGAAGATACGA	Plasma
Normal_GTGAAGGAGAGC	Plasma
Normal_GTGAAGTGCGAG	Plasma
Normal_GTGACCAAGGTC	Plasma
Normal_GTGACTGGTCTT	Plasma
Normal_GTGAGAATTAAC	HSPC
Normal_GTGAGCCCCCCC	Plasma
Normal_GTGAGTAGAAAC	cDC
Normal_GTGAGTGATCAT	HSPC
Normal_GTGCAAGCGTGC	CD4Memory
Normal_GTGCACGAATAT	Plasma
Normal_GTGCAGAAAGTG	Plasma
Normal_GTGCGTAACAAG	Plasma
Normal_GTGCTAGCTCCC	CD8Memory
Normal_GTGGATTCGGGT	Plasma
Normal_GTGGCACATTGG	Plasma
Normal_GTGGCAGCCCTC	CD4Memory
Normal_GTGGCCCCCGCT	Plasma
Normal_GTGGCCGGGTAG	Plasma
Normal_GTGGCGTATGCA	Plasma
Normal_GTGGCTATTGAA	Plasma
Normal_GTGGCTGGTAAG	HSPC
Normal_GTGGGTCCAGAG	Plasma
Normal_GTGGTGTCCACG	Plasma
Normal_GTGGTTATTGTT	HSPC
Normal_GTGTAACAAACT	CD4Memory
Normal_GTGTCCATCTCA	Plasma
Normal_GTGTCCCATTGT	Plasma
Normal_GTGTCGGAAAGG	HSPC
Normal_GTGTCGGAAGTG	CD4Memory
Normal_GTGTCGGGGCCT	CD4Memory
Normal_GTGTCTATAAGG	Plasma
Normal_GTGTGACGCTTC	HSPC
Normal_GTGTGGTAATCA	Plasma
Normal_GTGTGTCCTAGA	Plasma
Normal_GTGTGTTGTACA	Plasma
Normal_GTGTTACAATGA	Plasma
Normal_GTGTTTATATTG	Plasma
Normal_GTGTTTTCAGCC	Plasma
Normal_GTTAACATGCAC	Plasma
Normal_GTTACACCTCGG	Plasma
Normal_GTTACAGCTGAG	Plasma
Normal_GTTACGCTTGGT	Plasma
Normal_GTTATATACCAG	HSPC
Normal_GTTATCCACTAT	Plasma
Normal_GTTATCGCGGTG	cDC
Normal_GTTCAAAGGACC	Plasma
Normal_GTTCAAATCTAA	Plasma
Normal_GTTCACGAATTC	Plasma
Normal_GTTCGTAGAGGC	Plasma
Normal_GTTCGTTCTTAT	Plasma
Normal_GTTCTTGCCTGT	Plasma
Normal_GTTGAACGGGAA	Plasma
Normal_GTTGGAATAAGG	Plasma
Normal_GTTGGGCAACAG	Plasma
Normal_GTTGTCCCCAAC	Plasma
Normal_GTTTACAGCTCC	Plasma
Normal_GTTTACCTTCCG	CD4Memory
Normal_GTTTAGCCCCTC	Plasma
Normal_GTTTATGCTCAA	CD4Memory
Normal_GTTTCACTAGTG	Plasma
Normal_GTTTCATCTCAT	CD4Memory
Normal_GTTTCATTGACG	HSPC
Normal_GTTTCCTGTTTT	Plasma
Normal_GTTTCTTATAGA	Plasma
Normal_GTTTGAAGTGCG	Plasma
Normal_GTTTGACCGATG	cDC
Normal_GTTTGGAATCAA	Plasma
Normal_GTTTGTAGAAAC	Plasma
Normal_GTTTGTTATCTA	CD4Memory
Normal_GTTTTCTAACGG	Plasma
Normal_TAAAAAAGGTTA	cDC
Normal_TAAAACAGCTTG	cDC
Normal_TAAAAGGGAGGC	Plasma
Normal_TAAAATAGCACG	Plasma
Normal_TAAAGACTCTAA	Plasma
Normal_TAAAGATGAGAT	Plasma
Normal_TAAAGTCCTTGA	CD4Memory
Normal_TAAATAAAACCA	Plasma
Normal_TAAATATTCGAT	Plasma
Normal_TAAATCGAGTTT	Plasma
Normal_TAAATGGTCAGA	Plasma
Normal_TAAATGTGTCGA	Plasma
Normal_TAACAAGGCGTA	Plasma
Normal_TAACACATGGAG	Plasma
Normal_TAACATCGCAAC	Plasma
Normal_TAACCGGTAGTG	Plasma
Normal_TAACCTATAGAC	cDC
Normal_TAACGACTAATC	Plasma
Normal_TAACGGCAAATA	CD4Memory
Normal_TAACGGCTGCTC	Plasma
Normal_TAACGGGCCCGT	cDC
Normal_TAACGTCATGTC	Plasma
Normal_TAACGTGCCTCG	Plasma
Normal_TAAGATGTCCGC	Plasma
Normal_TAAGCCCGTACT	Plasma
Normal_TAAGCGGTCTCA	pDC
Normal_TAAGCGTATTAC	Plasma
Normal_TAAGCTCCGGGG	CD4Memory
Normal_TAAGGATAAGTA	Plasma
Normal_TAAGGGACCCCA	HSPC
Normal_TAAGTCCCTCTT	HSPC
Normal_TAAGTCTAACTC	Plasma
Normal_TAAGTGTGGGAT	Plasma
Normal_TAAGTTCCGTAA	CD4Memory
Normal_TAATATGGCCCT	Plasma
Normal_TAATCAATACTC	CD4Memory
Normal_TAATCGCGTAGA	Plasma
Normal_TAATCGGGTCCG	cDC
Normal_TAATGTCGATGG	HSPC
Normal_TAATTAGGCTAC	Plasma
Normal_TAATTCATGAAT	Plasma
Normal_TAATTCGGGACC	Plasma
Normal_TACAAGTCCGTA	Plasma
Normal_TACACAATTTCA	Plasma
Normal_TACAGAGCCCGC	Plasma
Normal_TACCAAAACGGG	Plasma
Normal_TACCACCCTTGC	Plasma
Normal_TACCACCGCTTT	Plasma
Normal_TACCAGATCTCG	Plasma
Normal_TACCATCCCTAC	Plasma
Normal_TACCATGCGGCT	HSPC
Normal_TACCCCAGGAGA	CD8Memory
Normal_TACCCGAACTGA	CD8TermExh
Normal_TACCCGCACTTG	HSPC
Normal_TACCGATCAGGA	Plasma
Normal_TACCGGAACGAT	Plasma
Normal_TACCTCTATAGT	HSPC
Normal_TACCTTCGTGTC	cDC
Normal_TACCTTGCGGGC	cDC
Normal_TACGAGAGTCCT	Plasma
Normal_TACGAGCAAGTA	Plasma
Normal_TACGCCTTTACG	Plasma
Normal_TACGCTGACGAT	cDC
Normal_TACGGACGCCTA	Plasma
Normal_TACGGATAAGAT	CD4Memory
Normal_TACGGCATGTCG	Plasma
Normal_TACGGCGGGTTT	cDC
Normal_TACGGGCATATA	Plasma
Normal_TACGGGGAGCCC	Plasma
Normal_TACGGGTGGTGC	Plasma
Normal_TACGGTAATAGG	Plasma
Normal_TACGGTATGTAC	Plasma
Normal_TACTAATCGTCT	Plasma
Normal_TACTACATTCCG	cDC
Normal_TACTCATAGTGG	Plasma
Normal_TACTCTGATCGA	Plasma
Normal_TACTGCTACAGG	Plasma
Normal_TACTGCTAGCCT	Plasma
Normal_TACTGGTGGGAT	Plasma
Normal_TAGAAGCATGTT	Plasma
Normal_TAGAAGGCGACC	cDC
Normal_TAGAATACACCC	Plasma
Normal_TAGACAAGCCTG	Plasma
Normal_TAGACAATGCTA	Plasma
Normal_TAGACGGCTTAT	CD4Memory
Normal_TAGACGGTGGAT	Plasma
Normal_TAGACTTTCTTA	Plasma
Normal_TAGATAAGGCGG	Plasma
Normal_TAGATACGTTCA	HSPC
Normal_TAGATATTCTGG	Plasma
Normal_TAGATATTGCTA	Plasma
Normal_TAGATGATGGCA	Plasma
Normal_TAGCAGGTCTGT	CD4Memory
Normal_TAGCATGGTACC	Plasma
Normal_TAGCCACAGTAT	Plasma
Normal_TAGCCGCTAGGG	Plasma
Normal_TAGCCTCATATA	Plasma
Normal_TAGCCTGTGATT	Plasma
Normal_TAGCGAACGCAT	HSPC
Normal_TAGCTACAAAGC	CD4Memory
Normal_TAGCTTTCTCTC	HSPC
Normal_TAGCTTTTAACG	Plasma
Normal_TAGGCCTTGTAG	CD4Memory
Normal_TAGGCTACTGGT	Plasma
Normal_TAGGGATCTAGT	Plasma
Normal_TAGGGCGTGTAA	Plasma
Normal_TAGTATTTGCTT	Plasma
Normal_TAGTCAACAAAT	Plasma
Normal_TAGTCGGGAAGG	Plasma
Normal_TAGTCTCCGTCC	Plasma
Normal_TAGTCTGCCAGC	Plasma
Normal_TAGTGCATGCGG	Plasma
Normal_TAGTGTTATCCC	CD4Memory
Normal_TAGTGTTGACTC	Plasma
Normal_TAGTTCTGCCCA	Plasma
Normal_TATAATTAAAGT	Plasma
Normal_TATACAATGTGG	Plasma
Normal_TATACTGCCTTG	Plasma
Normal_TATACTGCGTAT	Plasma
Normal_TATACTTTTCTC	Plasma
Normal_TATAGACCGGGC	Plasma
Normal_TATAGAGGTAAG	HSPC
Normal_TATATGTCCCAA	Plasma
Normal_TATATGTGTCAT	Plasma
Normal_TATCAGGAAGGA	Plasma
Normal_TATCCCGAACGT	Plasma
Normal_TATCCCGGACTC	Plasma
Normal_TATCCCGGCTAC	Plasma
Normal_TATCGAAAGGCC	Plasma
Normal_TATCGCAAGTGG	cDC
Normal_TATCTACCTTTA	Plasma
Normal_TATGAATCCTCA	Plasma
Normal_TATGACAGTTCT	cDC
Normal_TATGGTCCTAAG	Plasma
Normal_TATGGTGCCCAA	CD8TermExh
Normal_TATGTAATGCGA	CD8Naive
Normal_TATGTGAGAAGT	cDC
Normal_TATTAAGTCGAT	Plasma
Normal_TATTATCAACTA	CD4Memory
Normal_TATTCAAGACAT	Plasma
Normal_TATTCCCTGCTT	Plasma
Normal_TATTCTCGATAC	Plasma
Normal_TATTCTTAACTT	cDC
Normal_TATTGCTCCTTC	HSPC
Normal_TATTGTCATACG	Plasma
Normal_TATTTACCCACC	CD8Memory
Normal_TATTTACGTATT	Plasma
Normal_TATTTCTAGAAT	Plasma
Normal_TATTTTCCATTT	Plasma
Normal_TATTTTGCAGTC	CD8TermExh
Normal_TATTTTTCAGTT	cDC
Normal_TCAAAACCAGTT	HSPC
Normal_TCAAAAGCCGTT	HSPC
Normal_TCAAACTGTCCC	Plasma
Normal_TCAAAGGGAGCC	Plasma
Normal_TCAAATTGCCTG	CD8Naive
Normal_TCAACCGAGAGG	Plasma
Normal_TCAACGGCGATC	CD4Memory
Normal_TCAACTCCCTGC	Plasma
Normal_TCAAGCTTGAGT	Plasma
Normal_TCAATAAGGCTT	Plasma
Normal_TCAATTAAGCTG	HSPC
Normal_TCACAGCTTGGA	Plasma
Normal_TCACCAGGATCT	Plasma
Normal_TCACCGGATTAA	pDC
Normal_TCACGAACTGTG	Plasma
Normal_TCACGACAGACC	Plasma
Normal_TCACGTCTTGTT	Plasma
Normal_TCACTAAGGCGT	Plasma
Normal_TCACTACATATT	CD4Memory
Normal_TCACTGCCATTC	cDC
Normal_TCACTTGGGGGC	Plasma
Normal_TCAGATATATAA	Plasma
Normal_TCAGCGATCGAC	Plasma
Normal_TCAGCGCAACCA	Plasma
Normal_TCAGCTACTTAG	Plasma
Normal_TCAGGTACGTCG	Plasma
Normal_TCAGGTTCAGAG	Plasma
Normal_TCAGTGGCGACT	Plasma
Normal_TCATCTTACGTT	Plasma
Normal_TCATCTTGAAGT	Plasma
Normal_TCATTCCATGAC	Plasma
Normal_TCCAAATTGCAG	Plasma
Normal_TCCAACCCAACC	CD4Memory
Normal_TCCAAGCAAACG	Plasma
Normal_TCCACACTTCGT	CD4Memory
Normal_TCCACGTAACTA	Plasma
Normal_TCCACTGGCGAT	Plasma
Normal_TCCACTTTATCT	Plasma
Normal_TCCAGAAGAAGG	Plasma
Normal_TCCAGGACTTCT	Plasma
Normal_TCCAGGCCCTAG	Plasma
Normal_TCCAGGGTGGTA	Plasma
Normal_TCCAGTCAGGGT	Plasma
Normal_TCCATAGATCTA	HSPC
Normal_TCCCAAAATCGA	Plasma
Normal_TCCCAACGGCTG	HSPC
Normal_TCCCAACGTTCA	HSPC
Normal_TCCCCAAAGCCT	Plasma
Normal_TCCCCCTGGGGA	cDC
Normal_TCCCCTATATTA	CD4Memory
Normal_TCCCGACGTTAC	Plasma
Normal_TCCCGGCCGCGG	Plasma
Normal_TCCCGTAAACTG	Plasma
Normal_TCCCTAACGAAT	Plasma
Normal_TCCCTGGCAACT	CD4Memory
Normal_TCCCTGTAGCAC	Plasma
Normal_TCCCTTCCAATT	Plasma
Normal_TCCCTTGCCCCC	HSPC
Normal_TCCGAAAAGATC	HSPC
Normal_TCCGAACGATAA	Plasma
Normal_TCCGCGAGCTCA	Plasma
Normal_TCCGGGTCACCC	cDC
Normal_TCCGGTCGCCCA	CD4Memory
Normal_TCCTACGATACC	Plasma
Normal_TCCTAGAAAGCG	CD4Memory
Normal_TCCTCAATTCCC	ncMono
Normal_TCCTCCCCTCCT	Plasma
Normal_TCCTGAATCGCA	Plasma
Normal_TCCTGCGCACTC	Plasma
Normal_TCCTGTGGGGTA	HSPC
Normal_TCCTTAACAATT	Plasma
Normal_TCCTTCCATATC	HSPC
Normal_TCGAACCGCCCC	Plasma
Normal_TCGAACCGGTTT	Plasma
Normal_TCGAACTCTGCC	HSPC
Normal_TCGAACTTATAG	Plasma
Normal_TCGAAGATGGCT	Plasma
Normal_TCGAAGGGTTCC	CD4Memory
Normal_TCGAATCGTCTA	Plasma
Normal_TCGAATGAATGG	cDC
Normal_TCGACAAGCTGA	Plasma
Normal_TCGACGCGCAGA	Plasma
Normal_TCGAGATCCAAC	Plasma
Normal_TCGAGCAGCCCA	Plasma
Normal_TCGATTAGCGTC	Plasma
Normal_TCGATTCAGTCA	Plasma
Normal_TCGCATTTCTGG	Plasma
Normal_TCGCCAGCAGTC	Plasma
Normal_TCGCCCAGCAGA	Plasma
Normal_TCGCCTGGCCTA	Plasma
Normal_TCGCCTTCATAA	cDC
Normal_TCGCGGACGGTC	Plasma
Normal_TCGCGTACGAGA	CD4Memory
Normal_TCGCGTGGAGCG	CD4Memory
Normal_TCGCTAAACCGT	cDC
Normal_TCGCTACAATAT	Plasma
Normal_TCGCTCGATTGG	Plasma
Normal_TCGCTGCGCTAA	Plasma
Normal_TCGGAGATAGGT	Plasma
Normal_TCGGATACATCT	CD4Memory
Normal_TCGGATCGGCTG	Plasma
Normal_TCGGCTAGGGAT	cDC
Normal_TCGGGCTTACAT	Plasma
Normal_TCGGGTCAAGGC	Plasma
Normal_TCGGTAGAAACG	Plasma
Normal_TCGGTGCAACTG	Plasma
Normal_TCGGTGTCGAAA	Plasma
Normal_TCGGTGTGTGGA	Plasma
Normal_TCGGTTGTGAGT	Plasma
Normal_TCGGTTGTGGGG	Plasma
Normal_TCGTAAGCTTGC	Plasma
Normal_TCGTACAGAGGT	Plasma
Normal_TCGTAGCCCTAA	Plasma
Normal_TCGTCAATTGAA	Plasma
Normal_TCGTCGAGTGAC	Plasma
Normal_TCGTCGCGTGGA	Plasma
Normal_TCGTGAATAAGC	Plasma
Normal_TCGTGTCCCCCC	Plasma
Normal_TCGTTAAATCAG	Plasma
Normal_TCGTTTAGACAA	Plasma
Normal_TCGTTTATACTC	HSPC
Normal_TCTAATCCGAGG	Plasma
Normal_TCTACAGCACAT	CD8Naive
Normal_TCTACCTGGTAC	cDC
Normal_TCTAGCATACTC	Plasma
Normal_TCTCATCAAGGG	Plasma
Normal_TCTCATGGGCCC	Plasma
Normal_TCTCCGCTGTTG	CD4Memory
Normal_TCTCCTCCTCAC	HSPC
Normal_TCTCGATTTAAA	HSPC
Normal_TCTCGCGGGGCC	Plasma
Normal_TCTCTAATCTTT	Plasma
Normal_TCTGAAAATCAG	Plasma
Normal_TCTGAAAGGCCG	Plasma
Normal_TCTGAAGCCGAA	Plasma
Normal_TCTGACACTGCC	Plasma
Normal_TCTGACGATTAC	CD4Memory
Normal_TCTGAGTAGAGG	CD4Memory
Normal_TCTGATAGTGGC	CD4Memory
Normal_TCTGCAGAACTA	HSPC
Normal_TCTGCGGTATCG	Plasma
Normal_TCTGGAACAAAG	Plasma
Normal_TCTGTTACTGAT	Plasma
Normal_TCTGTTGACGGG	Plasma
Normal_TCTGTTGCAACC	Plasma
Normal_TCTTAATCTTAA	HSPC
Normal_TCTTCCGTCAAG	Plasma
Normal_TCTTCGAATGCT	Plasma
Normal_TCTTCGAGGCCT	Plasma
Normal_TCTTCTATCTAC	Plasma
Normal_TCTTGATGCGCA	Plasma
Normal_TCTTGGGCCTTG	Plasma
Normal_TCTTGTCCAAGA	Plasma
Normal_TCTTTAGGCTCT	Plasma
Normal_TCTTTCGAACAT	HSPC
Normal_TCTTTGCACTCG	cDC
Normal_TCTTTGTGCCAA	Plasma
Normal_TCTTTTCTGCGG	Plasma
Normal_TGAAACCCGCGC	Plasma
Normal_TGAAAGCCGGGT	CD4Memory
Normal_TGAACACCTAAA	HSPC
Normal_TGAACCGTCCGA	Plasma
Normal_TGAACGAACTCT	Plasma
Normal_TGAACTAAACGA	Plasma
Normal_TGAAGAGACACC	Plasma
Normal_TGAAGCGGAGGC	HSPC
Normal_TGAAGGACGAGA	HSPC
Normal_TGAAGGCAATGT	Plasma
Normal_TGAAGTTGACAC	Plasma
Normal_TGAATAAGGAAG	Plasma
Normal_TGAATCGCCATA	Plasma
Normal_TGAATTCGTAGG	Plasma
Normal_TGACCACCTCTA	cDC
Normal_TGACCCCAAAGG	HSPC
Normal_TGACCTGGCTAA	Plasma
Normal_TGACGCCCGACC	Plasma
Normal_TGACTAACCCGT	Plasma
Normal_TGACTACCTATG	Plasma
Normal_TGACTGCTCACC	cDC
Normal_TGAGCTCATAAA	cDC
Normal_TGAGCTTCTACT	Plasma
Normal_TGAGGATGTCCC	Plasma
Normal_TGAGTAAAAGGT	Plasma
Normal_TGAGTCTCGACA	Plasma
Normal_TGATAATATGAA	Plasma
Normal_TGATCCGAATTG	Plasma
Normal_TGATCGTGGATC	HSPC
Normal_TGATGAGGGCAC	cDC
Normal_TGATGCAATACG	cDC
Normal_TGATGGCTCATA	Plasma
Normal_TGATGGTATGGT	Plasma
Normal_TGATGGTGAGAA	Plasma
Normal_TGATTCCTCTAT	Plasma
Normal_TGATTCGAAGCC	HSPC
Normal_TGATTGGCGGGG	Plasma
Normal_TGATTGGTATCA	Plasma
Normal_TGATTGTTCCGG	HSPC
Normal_TGATTTGGTCTT	Plasma
Normal_TGCAAATAATCA	HSPC
Normal_TGCAACAGTCCA	CD4Memory
Normal_TGCAACGCCACC	CD8Memory
Normal_TGCAAGGCGTGC	Plasma
Normal_TGCAAGTTCATC	Plasma
Normal_TGCAATAGACGT	Plasma
Normal_TGCAATCGAGCA	Plasma
Normal_TGCACTAGTACG	CD4Memory
Normal_TGCAGACAGCAA	Plasma
Normal_TGCAGACCGTTC	Plasma
Normal_TGCAGGGAATAC	Plasma
Normal_TGCATGATGAGT	CD4Memory
Normal_TGCATGCGGGCT	HSPC
Normal_TGCATGTGTGGT	Plasma
Normal_TGCATTTCGGCA	Plasma
Normal_TGCCACGCGGGT	CD4Memory
Normal_TGCCACTTTCAG	Plasma
Normal_TGCCAGGAGCTA	Plasma
Normal_TGCCCATTGGAG	cDC
Normal_TGCCCGTGCCGA	Plasma
Normal_TGCCCTAGGCTG	cDC
Normal_TGCCCTATCAGT	Plasma
Normal_TGCCGCCACCAA	Plasma
Normal_TGCCGCCTGCCC	HSPC
Normal_TGCCGGCGAAAG	HSPC
Normal_TGCCGGGATTGA	Plasma
Normal_TGCCGGTCCCAT	Plasma
Normal_TGCCGTTCGTAG	Plasma
Normal_TGCCTAAGATCC	Plasma
Normal_TGCCTGATAATT	CD4Memory
Normal_TGCGACGGACAC	CD8Naive
Normal_TGCGAGAGCTCT	CD4Memory
Normal_TGCGATTCATAC	Plasma
Normal_TGCGATTTCAGT	Plasma
Normal_TGCGCGCCGATC	Plasma
Normal_TGCGTAGGTTTA	Plasma
Normal_TGCGTGTCTCTG	Plasma
Normal_TGCTACGGTTAC	Plasma
Normal_TGCTATTCTCAG	Plasma
Normal_TGCTCCGCAGCC	cDC
Normal_TGCTCCGCGTGT	Plasma
Normal_TGCTCCTTAGAG	Plasma
Normal_TGCTCTACCATT	Plasma
Normal_TGCTCTCTACCC	Plasma
Normal_TGCTTCAGAGAT	HSPC
Normal_TGCTTCCGTATC	Plasma
Normal_TGCTTGAACGGT	cDC
Normal_TGCTTTATACTA	Plasma
Normal_TGGAACGGCTCA	Plasma
Normal_TGGAATGTAGAA	Plasma
Normal_TGGACTACTCGC	CD4Memory
Normal_TGGACTTTATCT	Plasma
Normal_TGGAGCTTAGAG	CD4Memory
Normal_TGGAGGTCTCGA	cDC
Normal_TGGAGGTGGAGT	HSPC
Normal_TGGAGTGACGGC	Plasma
Normal_TGGATCACACTT	CD4Memory
Normal_TGGATCTGAGGA	pDC
Normal_TGGATGCCAAGC	Plasma
Normal_TGGATGCGACCC	cDC
Normal_TGGATGGAGAAT	Plasma
Normal_TGGATGTCCTAG	Plasma
Normal_TGGATTGACCCG	Plasma
Normal_TGGATTTGGAGT	Plasma
Normal_TGGCAATAACGC	Plasma
Normal_TGGCAGCTTTCA	Plasma
Normal_TGGCATCAATTC	cDC
Normal_TGGCATTTGCAA	Plasma
Normal_TGGCCGTACAAT	Plasma
Normal_TGGCGCTCTGAG	Plasma
Normal_TGGCTCCCTGCC	Plasma
Normal_TGGGAATATGCT	Plasma
Normal_TGGGACGTATAA	Plasma
Normal_TGGGCACAATGT	CD4Memory
Normal_TGGGCATGCTCT	Plasma
Normal_TGGGCGTGACCA	Plasma
Normal_TGGGGCCTTCCC	Plasma
Normal_TGGGGGGCTTTT	Plasma
Normal_TGGGTACGGTAC	Plasma
Normal_TGGTAACTTATG	pDC
Normal_TGGTAGACATTA	Plasma
Normal_TGGTATTTGTCA	cDC
Normal_TGGTCCAAACAG	CD8Memory
Normal_TGGTCCTACTGG	HSPC
Normal_TGGTCTCAGTAT	cDC
Normal_TGGTGCGCGGTG	Plasma
Normal_TGGTGGCCTGTT	Plasma
Normal_TGGTGGTCAAGA	Plasma
Normal_TGGTGGTGGGGA	Plasma
Normal_TGGTGTCTCCCT	Plasma
Normal_TGGTTCCTGATT	Plasma
Normal_TGGTTTTGGGCA	CD8TermExh
Normal_TGTAACGCTCGC	Plasma
Normal_TGTAAGTTCTCC	HSPC
Normal_TGTAATTTATCC	Plasma
Normal_TGTACTGTAAGC	Plasma
Normal_TGTAGCCTTCAA	Plasma
Normal_TGTAGCGATAAA	Plasma
Normal_TGTATAGTGCGC	Plasma
Normal_TGTATATGGCCC	Plasma
Normal_TGTCAAATAGCA	cDC
Normal_TGTCAACGTGGA	CD4Memory
Normal_TGTCACTTCCAT	Plasma
Normal_TGTCATCGAACT	Plasma
Normal_TGTCATCGGCCC	Plasma
Normal_TGTCCAGCTCCC	CD4Memory
Normal_TGTCCCTCAATT	cDC
Normal_TGTCCGCCGGAT	Plasma
Normal_TGTCGAGTATCG	Plasma
Normal_TGTCGTGCGTTA	cDC
Normal_TGTCGTGGGATG	Plasma
Normal_TGTCTCCCCCGC	HSPC
Normal_TGTGACACGGCC	Plasma
Normal_TGTGCAGCGATA	CD4Memory
Normal_TGTGCCGCGCTC	HSPC
Normal_TGTGCGCAATCG	Plasma
Normal_TGTGCGTAAGCG	Plasma
Normal_TGTGCTGAAGAA	Plasma
Normal_TGTGCTTGGAGG	Plasma
Normal_TGTGGCACATGA	Plasma
Normal_TGTGGCTCAACA	Plasma
Normal_TGTGGGGTCTCC	Plasma
Normal_TGTGGGTAGGCT	Plasma
Normal_TGTGGTGACCGA	Plasma
Normal_TGTGTGGACTTT	Plasma
Normal_TGTGTTTGCGCG	HSPC
Normal_TGTTAAAGCTGT	Plasma
Normal_TGTTAACACCTA	cDC
Normal_TGTTACCGTGCC	CD4Memory
Normal_TGTTAGATCGCA	Plasma
Normal_TGTTATCATAGT	HSPC
Normal_TGTTCCCACTAA	Plasma
Normal_TGTTCGTCTCAG	CD4Memory
Normal_TGTTCGTGGGTC	Plasma
Normal_TGTTGGAGGTGC	Plasma
Normal_TGTTGTTTTTGG	Plasma
Normal_TGTTTCACCTAT	cDC
Normal_TGTTTCAGGGGG	Plasma
Normal_TGTTTCCTCTAA	Plasma
Normal_TGTTTCGACTAC	Plasma
Normal_TTAACCTGTACG	Plasma
Normal_TTAACTACTGTG	cDC
Normal_TTAACTTTTCCC	Plasma
Normal_TTAAGCTACTTC	pDC
Normal_TTAAGGAACCCG	cDC
Normal_TTAAGGACCATG	HSPC
Normal_TTAAGGGAGTAG	HSPC
Normal_TTAAGGGTACCA	Plasma
Normal_TTAAGTGAATTA	Plasma
Normal_TTAATACTTGCG	B
Normal_TTACAATTGTGT	Plasma
Normal_TTACAGCAGCAG	Plasma
Normal_TTACATATTGAA	Plasma
Normal_TTACCCAGAGAG	Plasma
Normal_TTACCCCGCCCA	Plasma
Normal_TTACCGGTTATA	Plasma
Normal_TTACCTCCGCGT	CD4Memory
Normal_TTACGAGGGATG	HSPC
Normal_TTACGCTTAGCG	Plasma
Normal_TTACGCTTTAGA	Plasma
Normal_TTACTACGAGAA	cDC
Normal_TTACTAGAACAA	cDC
Normal_TTACTCACGGGC	Plasma
Normal_TTACTCGACTAA	Plasma
Normal_TTACTGCCACTC	Plasma
Normal_TTAGATCTCGAA	Plasma
Normal_TTAGATGCTGCG	Plasma
Normal_TTAGGAGGTACC	Plasma
Normal_TTAGGGGAAGCT	Plasma
Normal_TTAGGTCATGTG	cDC
Normal_TTAGTGTTGGGC	Plasma
Normal_TTAGTTCATATC	Plasma
Normal_TTATACATCTTA	Plasma
Normal_TTATCCATATAT	Plasma
Normal_TTATCCCGTCTG	Plasma
Normal_TTATGAAGCGGA	Plasma
Normal_TTATGCCCGACC	HSPC
Normal_TTATGCGTGCTA	cDC
Normal_TTATTATCAATA	cDC
Normal_TTATTGTTCTCC	HSPC
Normal_TTCAACCGCACC	Plasma
Normal_TTCAAGGATCAC	Plasma
Normal_TTCAATGGCCCC	CD4Memory
Normal_TTCACACCTGCG	CD4Memory
Normal_TTCACCAAATAG	Plasma
Normal_TTCAGAACGCAT	Plasma
Normal_TTCAGACGTACG	Plasma
Normal_TTCAGCCATAAT	Plasma
Normal_TTCAGGCCTGCA	Plasma
Normal_TTCAGGTGAAAC	cDC
Normal_TTCAGTGTTTAT	CD4Memory
Normal_TTCATCCGACTG	CD4Memory
Normal_TTCATTAGGCTG	Plasma
Normal_TTCCAAGCATGT	Plasma
Normal_TTCCATGGAGGC	Plasma
Normal_TTCCATGGGCGT	HSPC
Normal_TTCCGGTCAGGG	Plasma
Normal_TTCCTATTTTAC	Plasma
Normal_TTCCTCAACCCC	Plasma
Normal_TTCCTGATGTCT	Plasma
Normal_TTCGACGCTCAT	CD4Memory
Normal_TTCGCATATAAT	HSPC
Normal_TTCGCTGACCTA	Plasma
Normal_TTCGGCCGGTTA	CD4Memory
Normal_TTCGGTTAGTGA	CD4Memory
Normal_TTCGTAAAATGA	Plasma
Normal_TTCGTAAGTAAC	Plasma
Normal_TTCGTCCCTGTG	Plasma
Normal_TTCGTGTTAGAA	Plasma
Normal_TTCGTTTTTACC	CD4Memory
Normal_TTCTAACCGACC	Plasma
Normal_TTCTAAGCCGAT	Plasma
Normal_TTCTATACGATT	CD8Memory
Normal_TTCTGGAACTCT	Plasma
Normal_TTCTGTGATAAG	HSPC
Normal_TTCTTACCTCAG	Plasma
Normal_TTCTTGAGACAT	Plasma
Normal_TTGAAACTCCTT	Plasma
Normal_TTGAATAATTAC	CD4Memory
Normal_TTGACCTTTGCA	CD4Memory
Normal_TTGACGATCAAT	cDC
Normal_TTGACGTGCGAA	Plasma
Normal_TTGACTCGAATG	HSPC
Normal_TTGAGATCAGGG	cDC
Normal_TTGAGGTAAAGG	Plasma
Normal_TTGAGTTAGGCC	Plasma
Normal_TTGATAGAGCCA	cDC
Normal_TTGATGAACCTA	HSPC
Normal_TTGATTAGTCTC	Plasma
Normal_TTGCACCCTGTA	HSPC
Normal_TTGCACCTTGAC	HSPC
Normal_TTGCCCGGCGTC	Plasma
Normal_TTGCCCTCACAA	HSPC
Normal_TTGCCTAGCGGG	Plasma
Normal_TTGCCTTACTTA	Plasma
Normal_TTGCTCCTTGAA	Plasma
Normal_TTGCTTCGGAAC	Plasma
Normal_TTGGAGGCTAAT	HSPC
Normal_TTGGCATGGGAT	Plasma
Normal_TTGGCATTAAAT	Plasma
Normal_TTGGCGAGGCGT	cDC
Normal_TTGGCTAGTTGA	cDC
Normal_TTGGCTCGCCGC	Plasma
Normal_TTGGGATGTTGA	Plasma
Normal_TTGGGGTTACGG	Plasma
Normal_TTGGGTAGTAGC	CD4Memory
Normal_TTGGTAGTGCAT	cDC
Normal_TTGTAAGTGCGC	Plasma
Normal_TTGTAGGGTGCC	Plasma
Normal_TTGTATGGTATC	Plasma
Normal_TTGTTCGACATT	cDC
Normal_TTTAAGACCATG	Plasma
Normal_TTTACTTCAGAC	Plasma
Normal_TTTAGAATGCAT	CD4Memory
Normal_TTTAGATTCCAA	CD4Memory
Normal_TTTAGCCCCCTA	Plasma
Normal_TTTAGGCGATTT	Plasma
Normal_TTTAGGTATAGG	Plasma
Normal_TTTAGTTTGGTA	Plasma
Normal_TTTATAGGTTAG	Plasma
Normal_TTTATTAAACAA	Plasma
Normal_TTTATTTTGCTC	Plasma
Normal_TTTCAACCGTCA	Plasma
Normal_TTTCAATAAACC	Plasma
Normal_TTTCACATACAA	CD4Memory
Normal_TTTCACCTTGCC	Plasma
Normal_TTTCACTATCGT	Plasma
Normal_TTTCAGTAAGAT	Plasma
Normal_TTTCATTGGAGC	Plasma
Normal_TTTCCGTGCCTT	Plasma
Normal_TTTCGCGGATAT	Plasma
Normal_TTTCGCTCCACA	Plasma
Normal_TTTCGGTCAATA	CD4Memory
Normal_TTTCGGTGGGTC	Plasma
Normal_TTTCTAATTTGT	Plasma
Normal_TTTCTATGCCGT	HSPC
Normal_TTTGAAAGCGTA	Plasma
Normal_TTTGCGAGTGAG	Plasma
Normal_TTTGGAACTTGA	Plasma
Normal_TTTGGCCCATTA	Plasma
Normal_TTTGGCCGATGG	Plasma
Normal_TTTGGCGTCTAA	Plasma
Normal_TTTGGGTTCTGG	Plasma
Normal_TTTGTAAGTCGC	HSPC
Normal_TTTGTCTTGATT	cDC
Normal_TTTTATGTCCAT	Plasma
Normal_TTTTATTTCGAT	Plasma
Normal_TTTTCACCGTTT	Plasma
Normal_TTTTCGCCCAAG	Plasma
Normal_TTTTCGGAGAGC	Plasma
Normal_TTTTCTGCTGAT	cDC
Normal_TTTTGAACGAGC	Plasma
Normal_TTTTGACACACT	CD8TermExh
Normal_TTTTGCCAAAGA	ProB
Normal_TTTTGGATGCAG	Plasma
Normal_TTTTGTGTTTCG	CD4Memory
Normal_TTTTTATCACAA	Plasma
NS810_AAAAAAATCAAC	Plasma
NS810_AAAAAACAATGA	HSPC
NS810_AAAAACCGGCAA	Plasma
NS810_AAAAAGTCGCCT	Plasma
NS810_AAAAAGTGGCAG	Plasma
NS810_AAAAATAAGACT	ProB
NS810_AAAATTGAGCAT	Plasma
NS810_AAACATGTCGCG	Plasma
NS810_AAACCAGCGGAA	HSPC
NS810_AAACCATATTCC	Plasma
NS810_AAACCCCTATTA	cDC
NS810_AAACCGGTACAG	HSPC
NS810_AAACGCGGCGCG	cDC
NS810_AAACGGGACGAG	Plasma
NS810_AAACGGGTGAGG	Plasma
NS810_AAACGTCGCGCC	Plasma
NS810_AAACTCGCGGAC	Mono
NS810_AAACTGCATTAT	Plasma
NS810_AAACTGGACGCT	cDC
NS810_AAAGACGGAAGC	Plasma
NS810_AAAGTCGCCCAA	Plasma
NS810_AAATGCGCCAAC	Plasma
NS810_AAATTAATGGAC	Plasma
NS810_AAATTCAATGTC	Plasma
NS810_AACAAATGTCAC	Plasma
NS810_AACAATATCGAA	HSPC
NS810_AACACCGTTCAG	Plasma
NS810_AACAGAGTTACA	Plasma
NS810_AACAGGATGTTG	pDC
NS810_AACATAACCTGT	Plasma
NS810_AACATAGCCTAA	CD4Memory
NS810_AACATATAAGTT	Plasma
NS810_AACCAGGGCTGT	Plasma
NS810_AACCCCCCATCT	cDC
NS810_AACCCCTTTTGC	HSPC
NS810_AACCCTTTTTCG	Plasma
NS810_AACCGCCGTGCT	Plasma
NS810_AACGAATACCCA	Plasma
NS810_AACGACCGTACC	Plasma
NS810_AACGGACACGTG	Plasma
NS810_AACGGTATCGAG	Plasma
NS810_AACGTAATTATG	Plasma
NS810_AACGTGTACAGT	HSPC
NS810_AACGTTCGCGTC	Plasma
NS810_AACTAAAGCCGC	Plasma
NS810_AACTTGAGATAG	Plasma
NS810_AACTTGTCTTTC	Plasma
NS810_AACTTTTGGCTT	Plasma
NS810_AAGAAAGCACGG	Plasma
NS810_AAGAAAGCTTCA	HSPC
NS810_AAGAACCTATTA	Plasma
NS810_AAGAATGTCTAC	Plasma
NS810_AAGACACCCTTA	CD8TermExh
NS810_AAGACAGCGAGT	cDC
NS810_AAGACCATCTCC	cDC
NS810_AAGACGTGGTGG	Plasma
NS810_AAGCAGTGGTAT	HSPC
NS810_AAGCCCATTCCT	Plasma
NS810_AAGCTGATCATA	Plasma
NS810_AAGCTGCATGGT	HSPC
NS810_AAGGCCTAGGTG	Plasma
NS810_AAGGCGCTGCCT	Plasma
NS810_AAGGCTATATGT	Plasma
NS810_AAGTATGATAAA	Plasma
NS810_AAGTCACTCTAT	CD8Memory
NS810_AAGTCAGCTCAT	Plasma
NS810_AAGTCCTGGGAA	Plasma
NS810_AAGTCGGCCTCT	HSPC
NS810_AAGTGGCCGATG	Plasma
NS810_AAGTGGCGAAAA	Plasma
NS810_AATAAAGATCTC	Plasma
NS810_AATAACTATTGT	Plasma
NS810_AATAACTCTCCG	Plasma
NS810_AATAATGCAATT	HSPC
NS810_AATACCCTTGAA	Plasma
NS810_AATAGAGCCACG	Plasma
NS810_AATATATACAAT	Plasma
NS810_AATATTGATGAC	Plasma
NS810_AATCAAATCGCT	cDC
NS810_AATCAAGATTAG	Plasma
NS810_AATCATGCCGCG	HSPC
NS810_AATCCACCATCG	Plasma
NS810_AATCCGCATATG	Plasma
NS810_AATCGGTTAAGT	Plasma
NS810_AATCTAGACGTG	ProB
NS810_AATCTCTCTTTC	Plasma
NS810_AATGAAAAGCCG	Plasma
NS810_AATGCAATAGTT	HSPC
NS810_AATGCCCCATGC	Plasma
NS810_AATGCTAAATGG	cDC
NS810_AATGCTTCCTGC	HSPC
NS810_AATTGAGGAATC	Plasma
NS810_AATTGGTCTACT	Plasma
NS810_AATTTATGCGGA	Plasma
NS810_AATTTATGTTTT	Plasma
NS810_ACAAACCGTACT	Plasma
NS810_ACAAATCACGGC	Plasma
NS810_ACAACGCGGCAA	Plasma
NS810_ACAAGGAAGCAC	HSPC
NS810_ACAATAAGATTC	HSPC
NS810_ACAATGAGAGCG	Plasma
NS810_ACAATGCCCGTC	Plasma
NS810_ACAATTAACCCG	cDC
NS810_ACACTTACTAAG	Plasma
NS810_ACACTTGGTCAT	Plasma
NS810_ACAGCGCCTGTG	Plasma
NS810_ACAGGTATTGTC	HSPC
NS810_ACATATTCGACG	Plasma
NS810_ACATCAGAATGT	Plasma
NS810_ACATTTTTATTT	Plasma
NS810_ACCAACGTTGCG	B
NS810_ACCAAGTAGACG	Plasma
NS810_ACCAGGCTCATA	HSPC
NS810_ACCATCCGCTAG	Plasma
NS810_ACCCATCTCTTC	cDC
NS810_ACCCCGCGAGAG	Plasma
NS810_ACCCGCGGCCAG	Plasma
NS810_ACCCGGCGAGGG	Plasma
NS810_ACCCTCGGGAAC	Plasma
NS810_ACCCTGAGCAAC	pDC
NS810_ACCGACATTGGG	HSPC
NS810_ACCGGCACAGTT	Plasma
NS810_ACCGGTGGAGGG	HSPC
NS810_ACCGTATGCCGT	Plasma
NS810_ACCGTGCTTATC	HSPC
NS810_ACCTCAAGGAAC	Plasma
NS810_ACCTCATGGTGT	Plasma
NS810_ACCTCGCTTTAT	HSPC
NS810_ACCTCGTGGGAG	HSPC
NS810_ACCTCTTACGCC	CD4Memory
NS810_ACCTCTTATTAG	Plasma
NS810_ACGACGACAGAG	HSPC
NS810_ACGAGGGGGTCG	Plasma
NS810_ACGAGTTTATGA	Plasma
NS810_ACGATGGGCGTG	Plasma
NS810_ACGCAACATAAT	Plasma
NS810_ACGCACTACTTT	Plasma
NS810_ACGCCCTTCCCC	HSPC
NS810_ACGCCGATCCAT	Plasma
NS810_ACGCCGCCGACG	Plasma
NS810_ACGCTGATTGAA	HSPC
NS810_ACGGACCTTGGT	Plasma
NS810_ACGGCAACCACA	NK
NS810_ACGGGATTGTAC	Plasma
NS810_ACGGGTGTCGCT	Plasma
NS810_ACGGGTTGACTC	Plasma
NS810_ACGGTTATTCTC	HSPC
NS810_ACGGTTGCCTCC	HSPC
NS810_ACGTAAACGCTG	Plasma
NS810_ACGTAGTGAAGA	HSPC
NS810_ACGTCAGGTCGC	Plasma
NS810_ACGTGACGGCAG	cDC
NS810_ACGTGCGTAACT	HSPC
NS810_ACGTTACGGGGA	Plasma
NS810_ACGTTAGCCGAA	CD4Memory
NS810_ACGTTAGGTGAA	cDC
NS810_ACGTTATGAGTG	Plasma
NS810_ACTAACCCACTG	Plasma
NS810_ACTAACTCCGAG	Plasma
NS810_ACTAATCAAGAT	HSPC
NS810_ACTACCCATCTA	CD4Memory
NS810_ACTACCTGGGTA	cDC
NS810_ACTACCTGTCGC	Plasma
NS810_ACTAGAACTAGA	Plasma
NS810_ACTAGCCTGTCG	HSPC
NS810_ACTAGTTAAGGT	Plasma
NS810_ACTATCCCCGCG	Plasma
NS810_ACTCATCCTTGT	Plasma
NS810_ACTCGAGTTCGC	Plasma
NS810_ACTCGATTGCTC	Plasma
NS810_ACTCTAAGACGC	HSPC
NS810_ACTGAACGAATG	HSPC
NS810_ACTGAGAAGCAA	CD8TermExh
NS810_ACTGCCACTTTC	Plasma
NS810_ACTGCCAGCGAC	Plasma
NS810_ACTGGAGGTCGC	Plasma
NS810_ACTGGCTTAAAA	Plasma
NS810_ACTGGTACATAG	Plasma
NS810_ACTGTACGTACG	HSPC
NS810_ACTGTAGTTTTT	Plasma
NS810_ACTTAAGCTTTA	Plasma
NS810_ACTTAATACCTA	Plasma
NS810_ACTTAATTAGAT	Plasma
NS810_ACTTAGACACTG	Plasma
NS810_ACTTCGCAACGC	Plasma
NS810_ACTTGGCAGCAT	Plasma
NS810_ACTTGGTCATAG	Plasma
NS810_ACTTTACTCGGG	Plasma
NS810_ACTTTATCACGA	HSPC
NS810_ACTTTTCCACAC	Plasma
NS810_ACTTTTTCTCAG	pDC
NS810_AGAAAACCGTAG	Plasma
NS810_AGAAACAGTTGC	Plasma
NS810_AGAAACCGCGGC	HSPC
NS810_AGAAAGGATGGT	Plasma
NS810_AGAAAGGTTGGA	HSPC
NS810_AGAAATTCCAAG	pDC
NS810_AGAACACTTAAG	Plasma
NS810_AGAACTATTGCA	Plasma
NS810_AGAAGAAATTCC	Plasma
NS810_AGAATCCCAACC	HSPC
NS810_AGAATCCTAGGA	HSPC
NS810_AGACACTGATAC	HSPC
NS810_AGACATCTTGTC	Plasma
NS810_AGACCACCACAC	pDC
NS810_AGACCTTTACGA	Plasma
NS810_AGACGAGGTATA	Plasma
NS810_AGACGCGCTTTA	Plasma
NS810_AGACTATATTAC	HSPC
NS810_AGAGAAACTCGA	Plasma
NS810_AGAGAGTCAGGT	Plasma
NS810_AGAGAGTTGGAA	cDC
NS810_AGAGTAGCTATC	Plasma
NS810_AGATCAGACCTA	Plasma
NS810_AGATCGCAAGAA	CD4Memory
NS810_AGATGGTCTTGC	Plasma
NS810_AGATTGCTCCAG	Plasma
NS810_AGCAAACCGCGA	Plasma
NS810_AGCAAAGGATCA	HSPC
NS810_AGCAACATTATT	HSPC
NS810_AGCAATAGCACA	Plasma
NS810_AGCACGCACCAA	Plasma
NS810_AGCATGTGCAGC	HSPC
NS810_AGCCAAAACCTT	Plasma
NS810_AGCCAAAGAAAG	Plasma
NS810_AGCCACAACTAT	Plasma
NS810_AGCCGTATTGTT	Plasma
NS810_AGCGAAAACTGG	HSPC
NS810_AGCGAATGCACG	CD4Memory
NS810_AGCGAGACATCC	Plasma
NS810_AGCGAGGCGTTG	Plasma
NS810_AGCGGGGGCTGC	Plasma
NS810_AGCGTGAGCGTA	HSPC
NS810_AGCTGCGCATCC	Plasma
NS810_AGCTGGAAGGTG	Plasma
NS810_AGCTTCACGGGC	cDC
NS810_AGGAATAATTCA	HSPC
NS810_AGGACTGCAAAA	cDC
NS810_AGGAGGTCACGT	Plasma
NS810_AGGATCAGCAGA	Plasma
NS810_AGGATTCTATTT	CD4Memory
NS810_AGGCATGTAGCG	Plasma
NS810_AGGCGAGTCTAT	Plasma
NS810_AGGCGGGCGAGA	CD8TermExh
NS810_AGGGATGAGATG	Mono
NS810_AGGGGTCACAAA	cDC
NS810_AGGTACGCCAAC	Plasma
NS810_AGGTACTGTCCA	cDC
NS810_AGGTGGTGATGT	Plasma
NS810_AGGTTAGTTCGC	HSPC
NS810_AGTAAATGCCTT	Plasma
NS810_AGTAACTGGTGT	Plasma
NS810_AGTAGCTTTAAG	pDC
NS810_AGTAGGGCACTT	Plasma
NS810_AGTCACCGAGAT	HSPC
NS810_AGTCATCGAGGC	HSPC
NS810_AGTCGCTCCAGA	Plasma
NS810_AGTCTCCCATAT	HSPC
NS810_AGTCTTCGATCT	Plasma
NS810_AGTGATGAGGCG	Plasma
NS810_AGTGGTTCCCAA	Plasma
NS810_AGTGTCGCATAA	Plasma
NS810_AGTTCAAAGAGC	Plasma
NS810_AGTTGCTCTTAG	Plasma
NS810_AGTTTCTTACCG	pDC
NS810_AGTTTGCATTAA	Plasma
NS810_AGTTTGGGGATG	Plasma
NS810_ATAAAACGCCAC	HSPC
NS810_ATAAAAGTTAGC	HSPC
NS810_ATAAAGGTAGTA	cDC
NS810_ATAACATGCCAC	Plasma
NS810_ATAATCCATACC	cDC
NS810_ATACAACACGCG	Plasma
NS810_ATACATCCCTTT	Plasma
NS810_ATACCAGGACTA	HSPC
NS810_ATACCATCACGG	Plasma
NS810_ATACGACTAGCT	Plasma
NS810_ATACGCATGACG	CD4Memory
NS810_ATACGCCGCCGC	Plasma
NS810_ATACGGTGACAC	CD8TermExh
NS810_ATAGCGCCCTAC	Plasma
NS810_ATAGCTTTTTCG	Plasma
NS810_ATATAAATATTC	Plasma
NS810_ATATCAGTAATC	Plasma
NS810_ATATCGGCGGGT	Plasma
NS810_ATATGGGGAAGA	HSPC
NS810_ATATTGCTTGGT	Plasma
NS810_ATATTGGCGTTC	HSPC
NS810_ATCACTAACAGC	Plasma
NS810_ATCAGAAACTCT	Plasma
NS810_ATCAGATACGGC	Plasma
NS810_ATCATAACCGCC	Plasma
NS810_ATCCACATTCTT	Plasma
NS810_ATCCCCGCCCAT	HSPC
NS810_ATCCCTCTTGGA	HSPC
NS810_ATCCTGAAAGAG	Plasma
NS810_ATCGAAAATCAC	cDC
NS810_ATCGAACAGAGA	HSPC
NS810_ATCGCGTGCAAA	Plasma
NS810_ATCGCTTGTGCG	Plasma
NS810_ATCGTGAAGTGG	Plasma
NS810_ATCTCCCACTGC	Plasma
NS810_ATCTCGAGTTCT	Plasma
NS810_ATCTCTGCCCTT	Plasma
NS810_ATCTGAACGGGT	HSPC
NS810_ATCTGCGGTCGA	Plasma
NS810_ATCTGTAATTGA	HSPC
NS810_ATCTTTGGAGAA	Plasma
NS810_ATGAGAGAAGGC	CD4Memory
NS810_ATGAGGAGGAGC	cDC
NS810_ATGAGTGTCACC	Plasma
NS810_ATGATCAGGAGA	HSPC
NS810_ATGATGCGCGAA	HSPC
NS810_ATGATGGGCAAG	Plasma
NS810_ATGCCCTTGAAA	HSPC
NS810_ATGCCTACGATC	Plasma
NS810_ATGCCTGAGAAG	cDC
NS810_ATGCTCGGAACA	HSPC
NS810_ATGGCAAGTGAT	CD4Memory
NS810_ATGGCCCATTTA	Plasma
NS810_ATGGCGGCAAGC	Plasma
NS810_ATGGGGAGGGCG	Plasma
NS810_ATGGTCCCGGCT	Plasma
NS810_ATGGTCCGCATC	Plasma
NS810_ATGTAGATTAAG	Plasma
NS810_ATGTAGGGCTCA	Plasma
NS810_ATGTGCGAGTCA	Plasma
NS810_ATGTGCGCACGG	Plasma
NS810_ATTACACGACGT	Plasma
NS810_ATTACTTAAACG	Plasma
NS810_ATTATCAACCCA	cDC
NS810_ATTCAACAGCCG	cDC
NS810_ATTCACTTGCTT	Plasma
NS810_ATTCATGTTTAA	Plasma
NS810_ATTCATTCTTTT	HSPC
NS810_ATTCTCAATACC	ProB
NS810_ATTCTTATCGTC	Plasma
NS810_ATTCTTGTAAAT	Plasma
NS810_ATTGACTCTAGC	HSPC
NS810_ATTGACTTTCGA	HSPC
NS810_ATTGCAAAGATC	pDC
NS810_ATTGTTCTGTAG	Plasma
NS810_ATTTATTTAGGT	HSPC
NS810_ATTTCTATGTTC	cDC
NS810_ATTTTCGGCCCC	Plasma
NS810_CAAAACCTTGTC	Plasma
NS810_CAAACATCCTGG	Plasma
NS810_CAAACTATCTTG	Plasma
NS810_CAAATGTATTAC	Plasma
NS810_CAACAGTATGTG	cDC
NS810_CAACTGGCCATC	Plasma
NS810_CAAGGAGTTGAG	Plasma
NS810_CAAGGGTGTCCA	Plasma
NS810_CAAGGTGGGAAG	Plasma
NS810_CAATAGACGTTC	Plasma
NS810_CAATCCGACCGC	Plasma
NS810_CAATCTCGCACA	Plasma
NS810_CAATGATAAGTT	Plasma
NS810_CAATGTCTAACA	Plasma
NS810_CAATTACGAAAG	Plasma
NS810_CACACGAAATAT	HSPC
NS810_CACACTGCAAGT	Plasma
NS810_CACAGATCGGGC	HSPC
NS810_CACAGGTATCTA	Plasma
NS810_CACATCACGGCT	Plasma
NS810_CACCACACATCC	Plasma
NS810_CACCACTTCAGC	Plasma
NS810_CACCAGAAGATG	Plasma
NS810_CACCCAGTCACG	Plasma
NS810_CACCCCGGCACT	Plasma
NS810_CACCGACTCGTC	Plasma
NS810_CACCGCTAGTAT	Plasma
NS810_CACCGGCTTAAC	pDC
NS810_CACGAAAACACG	Plasma
NS810_CACGAGTATGGT	Plasma
NS810_CACGATTCATTA	Plasma
NS810_CACGATTTGCAA	Plasma
NS810_CACGCAAGTCGC	Plasma
NS810_CACGGATCATGA	Plasma
NS810_CACGGCCCCCCA	HSPC
NS810_CACGGTACTTTG	Plasma
NS810_CACGGTGTGCTG	Plasma
NS810_CACGTAACAGAA	Plasma
NS810_CACGTCTACGTC	Plasma
NS810_CACTAACTATTT	Plasma
NS810_CACTAGGATTTT	Plasma
NS810_CACTCACTATCA	Plasma
NS810_CACTGATGCAAC	HSPC
NS810_CACTGCCTACCC	Plasma
NS810_CACTTGTCTTGA	HSPC
NS810_CAGAAGCACGGG	Plasma
NS810_CAGACACCGGTT	Plasma
NS810_CAGACATTCGCA	Plasma
NS810_CAGAGATAGATG	Plasma
NS810_CAGAGGCCTTCG	Plasma
NS810_CAGCCGCTATCC	Plasma
NS810_CAGCGCGCGGGC	HSPC
NS810_CAGCGGACCTCG	HSPC
NS810_CAGCTGAATTAT	HSPC
NS810_CAGCTTAGACTG	Plasma
NS810_CAGGACCACGTC	HSPC
NS810_CAGGACCCCGTA	HSPC
NS810_CAGGTGCTACTC	HSPC
NS810_CAGGTGGTACGG	HSPC
NS810_CAGTAAGAACCA	Plasma
NS810_CAGTCCTAAGGG	Plasma
NS810_CAGTCTCCCTTT	CD4Memory
NS810_CAGTGAAGTATT	HSPC
NS810_CAGTGACACTCT	HSPC
NS810_CAGTGCTAGAAG	Plasma
NS810_CAGTGGGTCGGG	CD4Memory
NS810_CAGTGTCGTTGT	Plasma
NS810_CAGTTAGCGACC	HSPC
NS810_CAGTTCATCTGT	Plasma
NS810_CATACAAAATAG	Plasma
NS810_CATACAAATTCG	Plasma
NS810_CATACCTTGTCG	HSPC
NS810_CATATACTAACA	Plasma
NS810_CATATCCATGCT	Plasma
NS810_CATATTGTCTAA	Plasma
NS810_CATATTTGGAAC	Plasma
NS810_CATCAAACGACC	CD4Memory
NS810_CATCAATGCTTA	Plasma
NS810_CATCATGTTGAA	cDC
NS810_CATCCAATTGAG	HSPC
NS810_CATCCCTATTGC	Plasma
NS810_CATCCGTAACAG	cDC
NS810_CATCCTACATCG	Plasma
NS810_CATCGTGGGACC	cDC
NS810_CATCTAGAAAGC	Plasma
NS810_CATCTCTCTATA	Plasma
NS810_CATGAACGCACG	HSPC
NS810_CATGCATATCCG	HSPC
NS810_CATGCCGCTCAG	Plasma
NS810_CATGGATTAGGG	Plasma
NS810_CATGTGACTCAA	Plasma
NS810_CATGTTAATCGA	CD4Memory
NS810_CATTAATGATTG	Plasma
NS810_CATTACGTGCCG	cDC
NS810_CATTCGGCTGCT	Plasma
NS810_CATTGAGTTTTT	Plasma
NS810_CATTGTCTTACG	Plasma
NS810_CATTTGGATTAA	Plasma
NS810_CATTTGTTCGAA	cDC
NS810_CCAAAATTGCAG	Plasma
NS810_CCAAACTGCAAG	Plasma
NS810_CCAAGGTGTGAT	HSPC
NS810_CCAATCATGTTT	cDC
NS810_CCAATGTATTAA	Plasma
NS810_CCACACAACCAA	HSPC
NS810_CCACACGACAGT	Plasma
NS810_CCACAGAGTACG	Plasma
NS810_CCACATGCTAGG	CD4Memory
NS810_CCACCCGATGCC	HSPC
NS810_CCACGCACACGT	HSPC
NS810_CCACGGGCTTGC	Plasma
NS810_CCACTAAGTGTA	Plasma
NS810_CCACTGGCGTAT	HSPC
NS810_CCAGCTACAGCC	Mono
NS810_CCAGCTGCCTAC	Plasma
NS810_CCAGGCAAACGA	HSPC
NS810_CCAGGCCATTAG	Plasma
NS810_CCAGGTGAGGCG	Plasma
NS810_CCAGTCACATTA	Plasma
NS810_CCAGTGAACTTT	pDC
NS810_CCAGTTTATCTG	Plasma
NS810_CCATACATGATG	HSPC
NS810_CCATAGTGGTAT	Plasma
NS810_CCATCAATATAT	HSPC
NS810_CCATCCCCTGAG	HSPC
NS810_CCATGGTACACC	HSPC
NS810_CCATTGGCAATC	HSPC
NS810_CCCACTATCCGT	Plasma
NS810_CCCAGACTACCA	Plasma
NS810_CCCATAACAATT	Plasma
NS810_CCCATGCAACAC	HSPC
NS810_CCCCATACACCG	Plasma
NS810_CCCCCGCGAATG	Plasma
NS810_CCCCCGTGGCCT	HSPC
NS810_CCCCGGCCGCAC	Plasma
NS810_CCCCGTTCGCTC	HSPC
NS810_CCCCTACTAATC	Plasma
NS810_CCCCTGGTCCTA	Plasma
NS810_CCCGATTGACAG	HSPC
NS810_CCCGCCCCAGTG	cDC
NS810_CCCGCCGCGCTC	ProB
NS810_CCCGCGCCCACG	Plasma
NS810_CCCGCGGTGAGG	Plasma
NS810_CCCGCTGCTGGC	Plasma
NS810_CCCGGACCTCCA	HSPC
NS810_CCCTAAGTGCCC	Plasma
NS810_CCCTCAATAATA	HSPC
NS810_CCCTCGGCGTTC	HSPC
NS810_CCCTTATGTGCG	Plasma
NS810_CCGAAGCTGTTC	Plasma
NS810_CCGACGGTAGCT	CD8TermExh
NS810_CCGAGCTTTACT	Plasma
NS810_CCGAGTCGAGCA	Plasma
NS810_CCGATATATATG	Plasma
NS810_CCGATCCTGTAC	Plasma
NS810_CCGATGATCCTT	Plasma
NS810_CCGCACGACAGG	Plasma
NS810_CCGCTTATTAAA	Plasma
NS810_CCGGAAATGGGA	HSPC
NS810_CCGGAATCGCGA	cDC
NS810_CCGGGCAGGCTG	Plasma
NS810_CCGGGTAAGTGA	HSPC
NS810_CCGTAAACCGGT	CD8TermExh
NS810_CCGTCACAGGAC	Plasma
NS810_CCGTCACCCCGG	HSPC
NS810_CCGTCCCATCGG	Plasma
NS810_CCGTCTAGGGTG	cDC
NS810_CCGTCTCATTCT	Plasma
NS810_CCGTGCTCCGAT	cDC
NS810_CCGTGGCCCCCG	pDC
NS810_CCGTTAATCCCT	HSPC
NS810_CCGTTTGACTAA	Plasma
NS810_CCTAAGCAGTGG	HSPC
NS810_CCTACATCTCCG	Plasma
NS810_CCTACGCTACTG	Plasma
NS810_CCTACGGGGGGA	Plasma
NS810_CCTAGGAAGTCA	Plasma
NS810_CCTAGTACTGCT	HSPC
NS810_CCTAGTCTGATT	Plasma
NS810_CCTATTATTACG	Plasma
NS810_CCTATTGTTGCG	CD4Memory
NS810_CCTCAATCTAAG	HSPC
NS810_CCTCCACCGAGA	Plasma
NS810_CCTCCCCGGTAA	Plasma
NS810_CCTCCGATGCTG	Plasma
NS810_CCTCCGCCATCT	HSPC
NS810_CCTCCGCTGGTA	Plasma
NS810_CCTCGATTACCT	HSPC
NS810_CCTCGTGGCGAA	HSPC
NS810_CCTCTGGAACTT	ProB
NS810_CCTCTTACCAGA	Plasma
NS810_CCTGATAGGTAG	Plasma
NS810_CCTGCCGCTTGG	Plasma
NS810_CCTGCTTCGACG	Plasma
NS810_CCTGGGGTTTCA	HSPC
NS810_CCTGGGTGCGCA	pDC
NS810_CCTGTCAACCCA	Plasma
NS810_CCTGTTCCTAGC	cDC
NS810_CCTTATCTCGGC	Plasma
NS810_CCTTCAAGGCTT	HSPC
NS810_CCTTCAATCACC	Plasma
NS810_CCTTCACACCTT	Plasma
NS810_CCTTCAGAGGGG	Plasma
NS810_CCTTCCCTCGGG	HSPC
NS810_CCTTCGGGTGAA	HSPC
NS810_CCTTGGAGCTTA	Plasma
NS810_CCTTGTACTCCG	HSPC
NS810_CCTTTGTATCGT	Plasma
NS810_CCTTTTCATCCG	Plasma
NS810_CGAAAAAAAAAC	HSPC
NS810_CGAAATAAAACT	Plasma
NS810_CGAACAGCGAAA	HSPC
NS810_CGAACAGGGTGC	Plasma
NS810_CGAACGGGACTC	Plasma
NS810_CGAACTCCTCGA	Plasma
NS810_CGAAGTAAAGTT	Plasma
NS810_CGAATAAAAAGG	Plasma
NS810_CGAATGTGTTTA	HSPC
NS810_CGACGACTATAA	Plasma
NS810_CGAGGATTCTGT	Plasma
NS810_CGAGTGGTCTGA	Plasma
NS810_CGAGTTGAAGCA	cDC
NS810_CGATCGGGCCCT	Plasma
NS810_CGATCTCGTTGT	CD4Memory
NS810_CGATGCAAACAG	Plasma
NS810_CGATTAACTATG	HSPC
NS810_CGATTCAAGGTA	HSPC
NS810_CGATTTAGTGAC	Plasma
NS810_CGCAGCTACCAC	HSPC
NS810_CGCAGTCAAGAT	Plasma
NS810_CGCAGTCGCTCC	HSPC
NS810_CGCATGATCCAA	HSPC
NS810_CGCATGCATTCA	Plasma
NS810_CGCCGAAGCTAT	cDC
NS810_CGCCGCACGCGT	Plasma
NS810_CGCGACCAACGG	Plasma
NS810_CGCGCTAGTCTA	Plasma
NS810_CGCGTGAAATCA	HSPC
NS810_CGCTAGGTTGCG	HSPC
NS810_CGCTCGTTGTTA	HSPC
NS810_CGCTCTTGTAGT	cDC
NS810_CGCTTCGGGTCT	Plasma
NS810_CGGAATATTATG	Plasma
NS810_CGGAGATTGTGC	cDC
NS810_CGGAGTCCGAGC	HSPC
NS810_CGGATCGGGGGT	CD4Memory
NS810_CGGATGGTACCC	HSPC
NS810_CGGCATCAGTAA	Plasma
NS810_CGGCCGTTGACA	Plasma
NS810_CGGCCTAGTTAG	HSPC
NS810_CGGCGCTTTGTT	HSPC
NS810_CGGCTTAACTGT	Plasma
NS810_CGGGAGCAGTGT	Plasma
NS810_CGGGCGTCTCTA	HSPC
NS810_CGGGGTATACTA	Plasma
NS810_CGGGTTCTGCTG	HSPC
NS810_CGGTAACCCTTC	HSPC
NS810_CGGTGCATGAGA	Plasma
NS810_CGGTGCGCACAA	Plasma
NS810_CGGTGTCGCGAC	Plasma
NS810_CGGTTAGGTGCA	HSPC
NS810_CGTAAGAAAAAG	Plasma
NS810_CGTAATGCAGAA	Plasma
NS810_CGTACAACAATG	HSPC
NS810_CGTACGAATCTA	HSPC
NS810_CGTAGACATAAA	Plasma
NS810_CGTAGCCTGTCA	cDC
NS810_CGTAGGATTGTT	Plasma
NS810_CGTCAAGCACTA	Plasma
NS810_CGTCCCAGAGGG	Plasma
NS810_CGTCCGGATGTT	HSPC
NS810_CGTCCGTCGATC	Plasma
NS810_CGTCTGAATATG	CD8Memory
NS810_CGTGCTCCGAGT	cDC
NS810_CGTGGGACAGAG	HSPC
NS810_CGTGGTTCCCCA	HSPC
NS810_CGTGTTTCGATG	cDC
NS810_CGTTAGGCCTCA	Plasma
NS810_CGTTAGTAATAA	Plasma
NS810_CGTTATCATCAG	B
NS810_CGTTCATTCCGC	Plasma
NS810_CGTTGAGAAAGC	Plasma
NS810_CGTTGAGTGTCA	HSPC
NS810_CGTTGTGATTAT	ProB
NS810_CTAAATGCGTTT	HSPC
NS810_CTAAGCAGTGGT	Plasma
NS810_CTAAGTGTGCCG	Plasma
NS810_CTACACTGTCCT	HSPC
NS810_CTACGACAGTCG	Plasma
NS810_CTACGGTTACAC	Plasma
NS810_CTACTGAGTATT	CD4Memory
NS810_CTACTTGGAGAA	HSPC
NS810_CTAGAAGATGTA	Plasma
NS810_CTAGATAGGGCG	Plasma
NS810_CTAGATCTTTAC	Plasma
NS810_CTAGCTTCTATG	HSPC
NS810_CTAGGCGTATAA	Plasma
NS810_CTAGTGGTATCC	Plasma
NS810_CTATACAATACA	HSPC
NS810_CTATACCAGGGC	Plasma
NS810_CTATATGCTATT	Plasma
NS810_CTATCGACACTG	Plasma
NS810_CTATTGGGGTGG	Plasma
NS810_CTATTGTCGTAC	Plasma
NS810_CTCACGACCCCG	CD8Naive
NS810_CTCATACCAAGT	Plasma
NS810_CTCATAGAGTGA	Plasma
NS810_CTCCAACCGGGA	CD4Memory
NS810_CTCCAAGCGACC	Plasma
NS810_CTCCGAACCCGT	Plasma
NS810_CTCCGCGAACAC	Plasma
NS810_CTCCTCGGCGGA	cDC
NS810_CTCGAAGAGGCA	Plasma
NS810_CTCGACACCTCA	Plasma
NS810_CTCGCCGAGGGG	HSPC
NS810_CTCGGGGGTTCA	HSPC
NS810_CTCGTAGTCGAC	Plasma
NS810_CTCTAATGCGAA	ProB
NS810_CTCTCCGACGGT	Plasma
NS810_CTCTGAAGCAGT	Plasma
NS810_CTCTGGTATCTA	Plasma
NS810_CTCTTAAAGGGT	Plasma
NS810_CTCTTAGATGCT	Plasma
NS810_CTGAAGCGAGTA	Plasma
NS810_CTGAATCACGTT	Plasma
NS810_CTGAGACATTCT	Plasma
NS810_CTGAGACCTGGA	Plasma
NS810_CTGATTAGTATC	HSPC
NS810_CTGCACTCCACG	Plasma
NS810_CTGCATCGCGCA	Plasma
NS810_CTGCATTTATCT	cDC
NS810_CTGCGAGATGCC	HSPC
NS810_CTGCGCGCAGGA	Plasma
NS810_CTGCGGGCGCGG	Plasma
NS810_CTGGAACGCTCC	Plasma
NS810_CTGGACGGCGGA	Plasma
NS810_CTGGCACATCCA	Plasma
NS810_CTGGCAGCCGAT	Plasma
NS810_CTGGGTCTCCAA	HSPC
NS810_CTGGGTGCATAC	Plasma
NS810_CTGGTTTCGCTG	Plasma
NS810_CTGTCTTAGGGA	Plasma
NS810_CTGTGAAGCTTG	HSPC
NS810_CTGTTCCATCCC	Plasma
NS810_CTGTTGACAAAT	HSPC
NS810_CTTAACACGTGT	HSPC
NS810_CTTACCATGTAC	Plasma
NS810_CTTACTGATTTC	Plasma
NS810_CTTACTGGAAGG	HSPC
NS810_CTTATTGTATAA	Plasma
NS810_CTTCCGGGTGGA	Plasma
NS810_CTTCCTTTTTCA	Plasma
NS810_CTTCGCTACGCT	Plasma
NS810_CTTCTACGGGCG	HSPC
NS810_CTTGAGTTGAAC	Plasma
NS810_CTTGGCAAAGCG	Plasma
NS810_CTTGGGTAACGG	Plasma
NS810_CTTGTGACACTG	cDC
NS810_CTTTAACCCGGT	Plasma
NS810_CTTTGATTCCTA	HSPC
NS810_CTTTTCCAAACC	CD8Naive
NS810_CTTTTTAATTCC	Plasma
NS810_GAAAAATGGATA	cDC
NS810_GAAACTTCAATG	cDC
NS810_GAAAGGACGCTT	Plasma
NS810_GAAAGTTAGACC	Plasma
NS810_GAAATAAAAGTT	Plasma
NS810_GAAATATACCCC	Plasma
NS810_GAAATCTTTATC	Plasma
NS810_GAAATTAGATTG	cDC
NS810_GAAATTGCAATA	CD4Memory
NS810_GAACCAGGAAAT	B
NS810_GAACGCTGATTA	HSPC
NS810_GAACGTTGTTAG	HSPC
NS810_GAACTTCTAAAA	Plasma
NS810_GAAGGTAGATCG	CD4Memory
NS810_GAAGTCTCGAGG	HSPC
NS810_GAAGTTCATCAC	Plasma
NS810_GAAGTTCCTACT	Plasma
NS810_GAAGTTGCCGTC	Plasma
NS810_GAAGTTGTTCGT	Plasma
NS810_GAATCCGCCCAG	Plasma
NS810_GAATCGAGGGAA	Plasma
NS810_GAATCGTGAGTC	NK
NS810_GAATGGTACTGA	Plasma
NS810_GAATTTGCAATC	Plasma
NS810_GACAAACGGATA	CD8Memory
NS810_GACAAGTGATAA	Plasma
NS810_GACACACCGAAA	Plasma
NS810_GACAGTATAATA	Plasma
NS810_GACATCTATAAT	Plasma
NS810_GACATGCCAACG	CD4Memory
NS810_GACATTATCCCG	Plasma
NS810_GACATTTAACAT	HSPC
NS810_GACCGATCTCAG	HSPC
NS810_GACCGGGAGCGG	Plasma
NS810_GACCGTCTCTTG	Plasma
NS810_GACCGTGGGATT	cDC
NS810_GACCTACATCAC	HSPC
NS810_GACCTCGGATGC	HSPC
NS810_GACGGCCCCACC	Plasma
NS810_GACGGCTGGGGG	Plasma
NS810_GACGTCGTCGAT	Plasma
NS810_GACTACTCGGCT	Plasma
NS810_GACTCTACGAAT	Plasma
NS810_GACTGTTTCCAT	HSPC
NS810_GAGCCCAACCCT	Plasma
NS810_GAGCCGCTTGCC	HSPC
NS810_GAGCTATGTGAC	Plasma
NS810_GAGCTGGAGGTA	Plasma
NS810_GAGGATCGCTAG	CD8Naive
NS810_GAGGATTACTGG	Plasma
NS810_GAGGGGGACAGG	ProB
NS810_GAGGTTCTTCAC	CD8TermExh
NS810_GAGTACATTTCC	cDC
NS810_GAGTACTTCGGT	pDC
NS810_GAGTCCGTCAAG	HSPC
NS810_GAGTCTCTATCG	Plasma
NS810_GAGTGAGACCAC	cDC
NS810_GAGTGAGCATTT	HSPC
NS810_GAGTTACCTACG	Plasma
NS810_GAGTTGGAAACT	Plasma
NS810_GAGTTTAACAGG	Plasma
NS810_GATAAAATCAGC	Plasma
NS810_GATAAGGTACGC	CD4Memory
NS810_GATATCTCTTGA	Plasma
NS810_GATCAGGAACAG	Plasma
NS810_GATCCGGCGGAG	Plasma
NS810_GATCGAGCCGTC	HSPC
NS810_GATCTGTGGTTT	Plasma
NS810_GATGAGCGATCT	cDC
NS810_GATGATAGTTCT	Plasma
NS810_GATGCCCCCCGT	cDC
NS810_GATGCTAAATGC	Plasma
NS810_GATGGTGTAGTC	Plasma
NS810_GATTAAGGTTAT	cDC
NS810_GATTACTGTATA	Plasma
NS810_GATTAGTAAAAC	Plasma
NS810_GATTATGGTTAG	Plasma
NS810_GATTGAGTAGGT	HSPC
NS810_GATTGTAAATGT	Plasma
NS810_GCAAATTGCCCA	Plasma
NS810_GCAACGTGTCCG	cDC
NS810_GCAATCTAGGTC	HSPC
NS810_GCAATGAGTAAC	Plasma
NS810_GCACACTCCTAC	Plasma
NS810_GCACAGTATACA	Plasma
NS810_GCACAGTGGGCA	CD4Memory
NS810_GCACATCGAATG	Plasma
NS810_GCACCGAAGACG	Plasma
NS810_GCACGAGGTATA	Plasma
NS810_GCACGGTCTGAG	Plasma
NS810_GCACGTTCATCC	HSPC
NS810_GCACTCCCTTTC	Plasma
NS810_GCAGCGGACTTG	Plasma
NS810_GCAGGAGGGATC	Plasma
NS810_GCAGGATATAAT	Plasma
NS810_GCAGTACGTGGG	Plasma
NS810_GCAGTGGTATCA	Plasma
NS810_GCAGTGTTGAGT	HSPC
NS810_GCAGTTATGCAT	Plasma
NS810_GCATAACAAGTA	Plasma
NS810_GCATACACATTC	cDC
NS810_GCATACAGCAAC	HSPC
NS810_GCATACGGAATA	Plasma
NS810_GCATCAGGAGGT	HSPC
NS810_GCATCATGCATT	Plasma
NS810_GCATCCGCCCCC	Plasma
NS810_GCATGATATTTC	Plasma
NS810_GCATGTAATGCC	Plasma
NS810_GCATTGTGGTCC	Plasma
NS810_GCCCCGCGTTGT	Plasma
NS810_GCCCGTATCGTT	Plasma
NS810_GCCCTACACTGC	HSPC
NS810_GCCCTGAACTAC	HSPC
NS810_GCCCTGGATTGC	CD8TermExh
NS810_GCCCTTTCTCCG	Plasma
NS810_GCCGCTAATATT	cDC
NS810_GCCGTCTGCCTA	Plasma
NS810_GCCGTCTTTGAA	HSPC
NS810_GCCGTTGTCTCA	Plasma
NS810_GCCTAAATTTAA	HSPC
NS810_GCCTCCCGTGAG	HSPC
NS810_GCCTCTTCACGT	Plasma
NS810_GCCTGATTAAAG	Plasma
NS810_GCCTGCGCCGGT	Plasma
NS810_GCGAGGATGCCT	Plasma
NS810_GCGAGTGACGCC	Plasma
NS810_GCGCGAGAATCA	HSPC
NS810_GCGCGTGGAAGA	Plasma
NS810_GCGCTAAACCTG	HSPC
NS810_GCGCTAAGCGAA	HSPC
NS810_GCGCTCCCAGAT	HSPC
NS810_GCGGAATGTAAA	CD4Memory
NS810_GCGGCACCCGGT	Plasma
NS810_GCGGGTATTCCG	Plasma
NS810_GCGGGTTGCGAC	Plasma
NS810_GCGGTCAATAGG	Plasma
NS810_GCGGTGGCATCC	Plasma
NS810_GCGGTTGCTTGT	HSPC
NS810_GCGTAAATTGCA	Plasma
NS810_GCGTACCGGTCT	ProB
NS810_GCGTACTACGCT	Plasma
NS810_GCGTCACAGGCG	HSPC
NS810_GCGTCGATAGAC	Plasma
NS810_GCGTGGGACTAG	Plasma
NS810_GCTACTTATAGA	Plasma
NS810_GCTAGTTGTCAT	Plasma
NS810_GCTATGCATTCG	HSPC
NS810_GCTCAAACCACA	Plasma
NS810_GCTCAGGTTTTT	HSPC
NS810_GCTCCAAAGAGG	cDC
NS810_GCTCCACTCTAG	Plasma
NS810_GCTCGGCGTGTT	Plasma
NS810_GCTCGGTCTTCT	Plasma
NS810_GCTCGTCGTCCG	HSPC
NS810_GCTGACGGACGT	Plasma
NS810_GCTGAGCTCTAG	Plasma
NS810_GCTGCGAACCTA	Plasma
NS810_GCTGGAAGAGAG	Plasma
NS810_GCTGGCAGACTC	Plasma
NS810_GCTGGGTAGATT	cDC
NS810_GCTGGTCTAGTG	Plasma
NS810_GCTGTAGCCTAT	Plasma
NS810_GCTGTCACATTA	Plasma
NS810_GCTTAATTTCTC	Plasma
NS810_GGAAAGGCAGCG	HSPC
NS810_GGAAATAGTAAA	LateEry
NS810_GGAACAAATAAT	Plasma
NS810_GGAACATACACC	Plasma
NS810_GGAACCCCTATG	Plasma
NS810_GGAATAGCGCTA	Plasma
NS810_GGAATCCACTAA	cDC
NS810_GGAATCCCAAAA	Plasma
NS810_GGAATGCCATGG	Plasma
NS810_GGACCACCTGGC	Plasma
NS810_GGACGAGTGCGT	HSPC
NS810_GGACGCATATCT	HSPC
NS810_GGACTCGCGTAT	Plasma
NS810_GGAGAAATGAGT	Plasma
NS810_GGAGCCTAGATC	Plasma
NS810_GGAGGCTCGTTC	cDC
NS810_GGAGGGGGGCGC	Plasma
NS810_GGAGTAAGCTCG	cDC
NS810_GGAGTGTCGGCC	Plasma
NS810_GGATATCGCACA	Plasma
NS810_GGATATGCCGTT	Plasma
NS810_GGATCAGACAGT	cDC
NS810_GGATGCCATCGA	Plasma
NS810_GGATGCTATGGC	HSPC
NS810_GGATTACAGCGA	Plasma
NS810_GGATTACTTTTT	Plasma
NS810_GGATTTCAACAG	Plasma
NS810_GGCAACCCAAAC	Plasma
NS810_GGCAACTTCCCT	ProB
NS810_GGCAAGCTTACA	Plasma
NS810_GGCACCTGCCGA	Plasma
NS810_GGCACTCGCAGA	Plasma
NS810_GGCAGTAAGATT	Plasma
NS810_GGCCAATTTCCT	Plasma
NS810_GGCCAGGCTGCA	Plasma
NS810_GGCCCAGCGACT	Plasma
NS810_GGCCGTTGACAA	HSPC
NS810_GGCCTGCTCATT	Plasma
NS810_GGCGAGTCACCG	Plasma
NS810_GGCGATGGTTAG	CD8TermExh
NS810_GGCGCATATTGA	Plasma
NS810_GGCGTCAAATCT	Plasma
NS810_GGCGTGGCCGAA	cDC
NS810_GGCTATACTCAT	Plasma
NS810_GGCTCAAGCCTC	Plasma
NS810_GGGAATACCGGC	Plasma
NS810_GGGACCTCAAGG	Plasma
NS810_GGGAGAGACCCT	Plasma
NS810_GGGATCACTGGG	cDC
NS810_GGGATGAAATTC	Plasma
NS810_GGGCACGTCCCA	Plasma
NS810_GGGCCAGCGCGT	Plasma
NS810_GGGCGAACTCTC	HSPC
NS810_GGGCGCGAATAC	Plasma
NS810_GGGCTAACCACG	Plasma
NS810_GGGCTGGACCGT	HSPC
NS810_GGGGAGGACTAA	Plasma
NS810_GGGGCAGAAAGG	Plasma
NS810_GGGGGAAAAAAA	Plasma
NS810_GGGGGGCGTATC	Plasma
NS810_GGGGGGGAAACA	Plasma
NS810_GGGGGGGGAAAA	Plasma
NS810_GGGGTAACTTTC	Plasma
NS810_GGGGTAATCGCA	Plasma
NS810_GGGGTATCTTTT	CD8TermExh
NS810_GGGTATCAGATT	Plasma
NS810_GGGTATGTTGCC	Plasma
NS810_GGGTGTAGAGGA	cDC
NS810_GGGTTCAAACGT	Plasma
NS810_GGTACGGATGGT	Plasma
NS810_GGTATTTAACGC	Plasma
NS810_GGTCCCCAGCGA	Plasma
NS810_GGTCCGATCATC	Plasma
NS810_GGTCTCCGGCAA	Plasma
NS810_GGTCTGCTACCA	cDC
NS810_GGTCTTTTCAGT	Plasma
NS810_GGTGAACTAGTT	HSPC
NS810_GGTGACAAAACC	Plasma
NS810_GGTGACAGACGC	Plasma
NS810_GGTGCATGCTTG	Plasma
NS810_GGTGGAAAACAC	pDC
NS810_GGTGTGCGCTCT	Plasma
NS810_GGTTAATAGCGT	Plasma
NS810_GGTTAATTCTTG	HSPC
NS810_GGTTGCCCCGTT	Plasma
NS810_GGTTTCAGATAC	Plasma
NS810_GTAACTTTGACC	HSPC
NS810_GTACCATATGGG	Plasma
NS810_GTACCGGAAGAT	ProB
NS810_GTACGGCGACTG	Plasma
NS810_GTACTAGATCGC	HSPC
NS810_GTACTCCGGGGT	HSPC
NS810_GTACTGTTGCAT	Plasma
NS810_GTAGCATATCAC	Plasma
NS810_GTAGCCGACCGG	Plasma
NS810_GTAGGCCCGCCC	CD8Memory
NS810_GTAGGTTCATTC	CD4Memory
NS810_GTATAATCATAG	HSPC
NS810_GTATAGCGGCGG	cDC
NS810_GTATCGCCGGTC	HSPC
NS810_GTATGGCCTGGC	CD4Memory
NS810_GTATGGTACCAC	Plasma
NS810_GTATTCTCTTGC	Plasma
NS810_GTCAAATTATCG	Plasma
NS810_GTCAAGCAGCAG	Plasma
NS810_GTCAGCATTGCG	cDC
NS810_GTCATCATTGGC	Plasma
NS810_GTCATCGCATCA	Plasma
NS810_GTCATGCATGAA	HSPC
NS810_GTCCACTAGTGA	Plasma
NS810_GTCCCACAGATA	HSPC
NS810_GTCCCTCGCTAG	HSPC
NS810_GTCGAGAGCATT	Plasma
NS810_GTCGATCGGGAG	Plasma
NS810_GTCGCTTTGTTG	Plasma
NS810_GTCGGGGCTGCC	Plasma
NS810_GTCTATCTCTCC	ProB
NS810_GTCTCCCATGCA	CD4Memory
NS810_GTCTGGGTGATT	Plasma
NS810_GTCTGTAATTTG	HSPC
NS810_GTCTGTCACTGC	CD4Memory
NS810_GTGACACTCCCA	HSPC
NS810_GTGACCTTTTCT	Plasma
NS810_GTGACGTTCACC	Plasma
NS810_GTGAGGGACCAG	HSPC
NS810_GTGATATATAGC	cDC
NS810_GTGCACATACGA	Plasma
NS810_GTGCACTGCGTA	Plasma
NS810_GTGCCCTAATGT	Plasma
NS810_GTGCCTAGACAC	Plasma
NS810_GTGCTGATTCTA	Plasma
NS810_GTGCTTATTCTG	HSPC
NS810_GTGGGTTAAATA	ProB
NS810_GTGGGTTAAGTC	cDC
NS810_GTGGTGTCACAG	cDC
NS810_GTGTAATGGTCC	Plasma
NS810_GTGTCCCCGCCG	Plasma
NS810_GTGTCCGGACCA	HSPC
NS810_GTGTTAAGCTCC	Plasma
NS810_GTTAATGTGTAG	pDC
NS810_GTTACCGTACGT	Plasma
NS810_GTTACGGCAAAG	Plasma
NS810_GTTCGTGTACAC	Plasma
NS810_GTTCTACGTGGC	Plasma
NS810_GTTGAGTTGCTT	pDC
NS810_GTTTACCCCTTG	Plasma
NS810_GTTTAGCATGCC	Plasma
NS810_GTTTAGGTGTCA	Plasma
NS810_GTTTCTGGGGAC	Plasma
NS810_GTTTTCCACACG	Plasma
NS810_GTTTTCCCGTAG	HSPC
NS810_GTTTTGGATATT	Plasma
NS810_TAAACTTGACGA	Plasma
NS810_TAAAGGATCCGA	Plasma
NS810_TAACGATGTGCT	HSPC
NS810_TAACGGGCTAGT	Plasma
NS810_TAACTATTTTCG	Plasma
NS810_TAACTGAGCGAC	HSPC
NS810_TAACTGCCAATC	Plasma
NS810_TAAGAAAGAACT	cDC
NS810_TAAGAAGACTCA	HSPC
NS810_TAAGAATGTAGG	Plasma
NS810_TAAGCAAGCACT	cDC
NS810_TAAGCACGCCTG	HSPC
NS810_TAAGCAGTGGTA	Plasma
NS810_TAAGCCAGAACA	Plasma
NS810_TAAGCCGCTTGC	HSPC
NS810_TAAGGAGCAGTC	Plasma
NS810_TAAGGCCAGCAG	HSPC
NS810_TAAGGCCTGAGT	Plasma
NS810_TAAGGGAGCGAG	Plasma
NS810_TAAGTCTAGCTG	cDC
NS810_TAAGTGAGCCAA	Plasma
NS810_TAAGTTCATACT	HSPC
NS810_TAATCACGGGTC	cDC
NS810_TAATCATTGCGG	Plasma
NS810_TAATCCAGCCGA	Plasma
NS810_TAATGTACCTTA	Plasma
NS810_TAATTCCACCCC	Plasma
NS810_TACAACAAGTGG	Plasma
NS810_TACACCGACAGA	Plasma
NS810_TACACTAGTGGT	HSPC
NS810_TACAGACTGCTG	Plasma
NS810_TACAGTAACAAT	Plasma
NS810_TACAGTCCCTTG	HSPC
NS810_TACATACCCGTT	Plasma
NS810_TACATCTCTCGA	HSPC
NS810_TACATTACTTAC	Plasma
NS810_TACCAAGAGCGA	cDC
NS810_TACCACCCCCTG	cDC
NS810_TACCCTCTGCCG	Plasma
NS810_TACCGCAACACC	cDC
NS810_TACCTAGGTAAG	Plasma
NS810_TACGCGTGGGAC	Plasma
NS810_TACGCTCCCCGC	HSPC
NS810_TACGGCCGACCC	HSPC
NS810_TACTCGAAATAC	HSPC
NS810_TACTCGGCCAAC	Plasma
NS810_TACTGCACCGTC	Plasma
NS810_TACTGCTAGCGT	HSPC
NS810_TACTGGGGTATC	HSPC
NS810_TACTTGCTAATA	CD8Naive
NS810_TAGAAACATCGA	cDC
NS810_TAGAGGCGCTTA	Plasma
NS810_TAGCAAAAAGAG	CD4Memory
NS810_TAGCAACAACTG	Plasma
NS810_TAGCAGCGTTCG	HSPC
NS810_TAGCATTAGTTC	Plasma
NS810_TAGCCATCGCAG	Plasma
NS810_TAGCCCTAGCCA	CD4Memory
NS810_TAGCGAAGGAAC	Plasma
NS810_TAGCGACCCGAA	HSPC
NS810_TAGCGAGCTATG	Plasma
NS810_TAGCGATTCCAA	Plasma
NS810_TAGCGGACTGGC	Plasma
NS810_TAGCTACTTGTA	Plasma
NS810_TAGCTCTAAAAA	Plasma
NS810_TAGCTTCAGTCT	Plasma
NS810_TAGGAGTCAGGG	Plasma
NS810_TAGGCCGAACCG	Plasma
NS810_TAGGCTAGACCT	Plasma
NS810_TAGGCTCCTGGT	HSPC
NS810_TAGGGAGGTTTC	Plasma
NS810_TAGGGCACATTA	cDC
NS810_TAGGTCCAGAAG	Plasma
NS810_TAGGTGGACCCC	Plasma
NS810_TAGTCCACGTGT	Plasma
NS810_TAGTCGGCCTTG	HSPC
NS810_TAGTGTTGAATA	Plasma
NS810_TAGTTCATTGCA	Plasma
NS810_TAGTTCGCGCTG	cDC
NS810_TATAAATACTCA	Plasma
NS810_TATAATGTCCTG	Plasma
NS810_TATACCATCCAT	HSPC
NS810_TATACTGAAACC	cDC
NS810_TATACTGTGGGC	Plasma
NS810_TATAGAAACCGT	HSPC
NS810_TATAGGAAGGTG	CD4Memory
NS810_TATATCGCGGAG	Plasma
NS810_TATCAATCTTTG	Plasma
NS810_TATCACTCAGAA	Plasma
NS810_TATCAGATGACC	cDC
NS810_TATCCCAACACA	HSPC
NS810_TATCGCCAAGGA	Plasma
NS810_TATCGGAGCGAG	Plasma
NS810_TATCTAGTCCCA	HSPC
NS810_TATGAGAGTGGA	Plasma
NS810_TATGATGCCAGT	ProB
NS810_TATGCCAGACTG	Plasma
NS810_TATGCGGCGACG	HSPC
NS810_TATGGGTGAACG	pDC
NS810_TATGGTACCAGG	Plasma
NS810_TATGTCAAGCAG	Plasma
NS810_TATTAGTCAGTA	cDC
NS810_TATTATTACGCT	Plasma
NS810_TATTCAGACACA	Plasma
NS810_TATTCGGAAACG	HSPC
NS810_TATTGCCTCCAT	Plasma
NS810_TATTGTCATCAT	Plasma
NS810_TCAAGGCGAGCC	Plasma
NS810_TCACAAAGGTAG	Plasma
NS810_TCACAACAATGA	Plasma
NS810_TCACAGACAGGT	Plasma
NS810_TCACAGAGCGGC	cDC
NS810_TCACCACCAGAC	Plasma
NS810_TCACCCTACCGG	Plasma
NS810_TCACCCTCCCAC	Plasma
NS810_TCACCCTTCACC	HSPC
NS810_TCACCGAGATCT	Plasma
NS810_TCACGCCGATTT	HSPC
NS810_TCACGTAATCCG	HSPC
NS810_TCACTCCCCGGA	Plasma
NS810_TCACTCCGGTTT	LateEry
NS810_TCACTTCGTGGT	Plasma
NS810_TCAGAAGCATCG	Plasma
NS810_TCAGCGCCGCGA	HSPC
NS810_TCAGCTGGGCCC	Plasma
NS810_TCAGTACAACTC	Plasma
NS810_TCAGTTCAGCGC	HSPC
NS810_TCATACGTGACC	Plasma
NS810_TCATGCATCAAC	HSPC
NS810_TCATGCTTATCC	Plasma
NS810_TCATGGCAGGCC	cDC
NS810_TCATTACTGCAC	Plasma
NS810_TCATTCTTACGC	Plasma
NS810_TCCAAGAAGTTG	Plasma
NS810_TCCAAGGGATAG	Plasma
NS810_TCCAATGTCGTC	Plasma
NS810_TCCACAACTTCT	Plasma
NS810_TCCAGATCGCGG	Plasma
NS810_TCCAGGCAGCCG	cDC
NS810_TCCATCTAAGGG	HSPC
NS810_TCCATTGACTTC	HSPC
NS810_TCCCAAATCAAT	CD4Memory
NS810_TCCCAGCAGCCT	Plasma
NS810_TCCCAGTGGATG	Plasma
NS810_TCCCCCGGTCCG	Plasma
NS810_TCCCCTGATAAC	Plasma
NS810_TCCCCTTTCCTA	Plasma
NS810_TCCCTACTAGTC	Plasma
NS810_TCCCTCCAGGTG	Plasma
NS810_TCCCTCGTTTCA	Plasma
NS810_TCCGCCTAGGAC	Plasma
NS810_TCCGCGAGGGAT	cDC
NS810_TCCGCTCTCACT	Plasma
NS810_TCCGGCCAGTTG	Plasma
NS810_TCCGGTGGTAAT	Plasma
NS810_TCCGTTTCCTTG	HSPC
NS810_TCCTAAGCAGTG	Plasma
NS810_TCCTACAATGGG	Plasma
NS810_TCCTACTTATAC	HSPC
NS810_TCCTCATTTGAT	Plasma
NS810_TCCTCCATAGCG	Plasma
NS810_TCCTCCGGTTCG	HSPC
NS810_TCCTCTACACTC	Plasma
NS810_TCCTGCCAATCC	Plasma
NS810_TCCTGGTACATA	cDC
NS810_TCCTTGCGCACA	cDC
NS810_TCGAAAAGTCCT	Plasma
NS810_TCGACGTTTCAT	Plasma
NS810_TCGAGGACCGCC	Plasma
NS810_TCGAGGAGCTGC	Plasma
NS810_TCGAGTGCCGCA	Plasma
NS810_TCGATCGTAGTT	cDC
NS810_TCGCACTCCCGC	Plasma
NS810_TCGCAGGCCTTC	Plasma
NS810_TCGCCGGGGCCT	Plasma
NS810_TCGCGAGTGTTA	HSPC
NS810_TCGCTAATATAT	cDC
NS810_TCGGCCGCATTC	Plasma
NS810_TCGGCCTTAGGC	Plasma
NS810_TCGGCGTGGAGC	Plasma
NS810_TCGTATCGAGCG	cDC
NS810_TCGTTGCGCGAT	Plasma
NS810_TCGTTGTAAGGC	HSPC
NS810_TCGTTTTTATCA	HSPC
NS810_TCTAACCCGCAG	cDC
NS810_TCTATCTCCAAT	Plasma
NS810_TCTATGCGCCAT	NKT
NS810_TCTATTTCCTAT	Plasma
NS810_TCTCGATATCTA	CD8TermExh
NS810_TCTCGTAACCTC	Plasma
NS810_TCTCGTAGGGAG	Plasma
NS810_TCTGAAGCGTGC	Plasma
NS810_TCTGATCAAAGC	HSPC
NS810_TCTGCGCAGGAA	Plasma
NS810_TCTGGGCATGGA	Plasma
NS810_TCTTCGTGAAGA	Plasma
NS810_TCTTTACGCTGC	cDC
NS810_TCTTTCTTGCGG	HSPC
NS810_TGAAACAATGCT	Plasma
NS810_TGAAAGGCGTAG	Plasma
NS810_TGAAATTACCCG	Plasma
NS810_TGAACGAGGCAC	Plasma
NS810_TGAACGTTTGAT	Plasma
NS810_TGAAGACACCGG	cDC
NS810_TGAATGCTAGGC	Plasma
NS810_TGACAGTAATAA	Plasma
NS810_TGACCCTGTCCT	Plasma
NS810_TGACCTCCTAAT	Plasma
NS810_TGACGTGGTGTC	HSPC
NS810_TGACGTTTAGTC	Plasma
NS810_TGACTGAAAACA	Plasma
NS810_TGACTGTGACAT	cDC
NS810_TGAGAAGTCTCC	Plasma
NS810_TGAGATAAGATT	Plasma
NS810_TGAGCAAATCAC	cDC
NS810_TGAGCCATGCGA	cDC
NS810_TGAGCCCTCAGA	HSPC
NS810_TGAGCCTAGCGA	Plasma
NS810_TGAGCGGTTCCT	Plasma
NS810_TGAGGTGCTAGA	Plasma
NS810_TGAGTAGCTCCA	Plasma
NS810_TGATACAAGAGT	HSPC
NS810_TGATAGTACTAT	Plasma
NS810_TGATCCAAAGAA	Plasma
NS810_TGATCGGTTAGG	Plasma
NS810_TGATGGAGAAAA	Plasma
NS810_TGCACCCATATA	HSPC
NS810_TGCACCCTTGGG	HSPC
NS810_TGCACGTGAGTG	Plasma
NS810_TGCACTTATGGC	Plasma
NS810_TGCAGCTGCACT	Plasma
NS810_TGCAGTATAGGC	pDC
NS810_TGCCAGATCCGG	HSPC
NS810_TGCCGCATTCCG	Plasma
NS810_TGCCGGTGTCAC	HSPC
NS810_TGCCGTATAAGG	HSPC
NS810_TGCCGTTCCGAC	CD4Memory
NS810_TGCCTCGTGTCC	Plasma
NS810_TGCGAAGTGAGT	Plasma
NS810_TGCGGAACAAGA	HSPC
NS810_TGCGTTACTTCT	Plasma
NS810_TGCTAAGGTGCG	HSPC
NS810_TGCTACAAACTA	Plasma
NS810_TGCTAGTAAGTT	Plasma
NS810_TGCTCCCCTATA	HSPC
NS810_TGCTCCGTGCCT	Plasma
NS810_TGCTTGCAACTA	Plasma
NS810_TGCTTTAACCAC	cDC
NS810_TGGAAAGTGACG	Plasma
NS810_TGGAACAAGCAC	HSPC
NS810_TGGACAATCAGG	CD4Memory
NS810_TGGACTCTAGCC	Plasma
NS810_TGGAGACGAGGC	Plasma
NS810_TGGAGCGGTCGA	HSPC
NS810_TGGAGGCAGGCG	Plasma
NS810_TGGATCTGTTGA	HSPC
NS810_TGGCAACATGAC	Plasma
NS810_TGGCACCGATCC	Plasma
NS810_TGGCATCGCTAC	Plasma
NS810_TGGCCTAGAGAT	Plasma
NS810_TGGCGTAGCCGG	pDC
NS810_TGGCTCCCATCA	Plasma
NS810_TGGCTGTTATTT	HSPC
NS810_TGGGAACAATAG	Plasma
NS810_TGGGAGTGAGGG	Plasma
NS810_TGGGATACCGGT	Plasma
NS810_TGGGCACGCAAG	HSPC
NS810_TGGGGATCCGAC	CD4Memory
NS810_TGGGGGGGGGGG	Plasma
NS810_TGGTAACGGTCT	Plasma
NS810_TGGTCACACATG	Plasma
NS810_TGGTCGACCATC	cDC
NS810_TGGTTAATGGCT	Plasma
NS810_TGTACGTGCGAC	cDC
NS810_TGTACTGTAGAT	Plasma
NS810_TGTAGACTACGG	Plasma
NS810_TGTAGAGCGTAG	cDC
NS810_TGTATCTTTCGG	cDC
NS810_TGTATTGCTACT	Plasma
NS810_TGTCAACGTCCA	HSPC
NS810_TGTCAATGGGGT	HSPC
NS810_TGTCAGTGAAGC	Plasma
NS810_TGTCATGTGAGA	Plasma
NS810_TGTCCATCCGTG	Plasma
NS810_TGTCGAGCTATA	Plasma
NS810_TGTCGCATAATA	Plasma
NS810_TGTCGCGGACTG	Plasma
NS810_TGTCGCGTGACA	Plasma
NS810_TGTCGTCCATTA	Plasma
NS810_TGTCTGATTTCG	HSPC
NS810_TGTCTGGCGAAC	HSPC
NS810_TGTGCAGAACCT	HSPC
NS810_TGTGCTAAAAGT	HSPC
NS810_TGTGGATTCTCA	HSPC
NS810_TGTGGCTACAGC	HSPC
NS810_TGTGGGGGCCGT	HSPC
NS810_TGTGTATTGACC	Plasma
NS810_TGTTCTAGGATG	Plasma
NS810_TGTTGACGTTCT	cDC
NS810_TGTTGATCTGAA	Plasma
NS810_TGTTGCTTGCCA	HSPC
NS810_TGTTGGCCCAGT	cDC
NS810_TGTTTGTAGTCT	Plasma
NS810_TGTTTTAGAAAG	Plasma
NS810_TGTTTTTACTGA	Plasma
NS810_TTAAACTTACCT	Plasma
NS810_TTAACAAGAGGG	Plasma
NS810_TTAACCAGTGTG	HSPC
NS810_TTAAGAACACTG	Plasma
NS810_TTAAGACCGTGC	Plasma
NS810_TTAAGTATCCAC	HSPC
NS810_TTAATAACGTTC	Plasma
NS810_TTACAAGACCCA	Plasma
NS810_TTACAGGAGTCT	Plasma
NS810_TTACATGGCCCG	HSPC
NS810_TTACTACAAAGG	Plasma
NS810_TTACTGACGAGG	HSPC
NS810_TTACTGTCATTG	Plasma
NS810_TTAGTAAACTGC	Plasma
NS810_TTAGTTCCTTTA	Plasma
NS810_TTATAGGACCAT	HSPC
NS810_TTATAGTAGAGA	Plasma
NS810_TTATATCCAGAT	Plasma
NS810_TTATCAAGTATG	Plasma
NS810_TTATCGTCCATT	cDC
NS810_TTATGAATTCTG	Plasma
NS810_TTATGCATAAAC	Plasma
NS810_TTATGCTAGTTC	Plasma
NS810_TTATTAGAAGAC	Plasma
NS810_TTATTCTCGAGG	cDC
NS810_TTCAACGATCGG	Plasma
NS810_TTCAAGCCTTTT	HSPC
NS810_TTCAAGCGATGG	Plasma
NS810_TTCACGTAATCT	CD4Memory
NS810_TTCAGTACTGTC	Plasma
NS810_TTCATACAACCT	cDC
NS810_TTCCAACGGCCG	Plasma
NS810_TTCCAATTTTCG	Plasma
NS810_TTCGAACCTGTA	cDC
NS810_TTCGCGACCCCG	CD4Memory
NS810_TTCGCTACGGAG	Plasma
NS810_TTCGCTGGCGCC	Plasma
NS810_TTCGCTGTACCC	HSPC
NS810_TTCGGGTCCGTT	Plasma
NS810_TTCGGTGGAGAA	cDC
NS810_TTCGGTTCTAGA	HSPC
NS810_TTCGTATACGCT	HSPC
NS810_TTCGTGCATGAG	Plasma
NS810_TTCGTTAGAAGG	Plasma
NS810_TTCTACGTTACT	Plasma
NS810_TTCTATTTCCTT	HSPC
NS810_TTCTCAGTTATG	HSPC
NS810_TTCTCGTCACGG	Plasma
NS810_TTCTGTAGGTAC	HSPC
NS810_TTCTTTTTGCTA	Plasma
NS810_TTGAAACTTACG	Plasma
NS810_TTGACGATAGGC	Plasma
NS810_TTGAGGACCTCG	Plasma
NS810_TTGAGTTTGCAG	Plasma
NS810_TTGCAGTACTTA	HSPC
NS810_TTGCATGATTAT	Plasma
NS810_TTGCCAAACAAC	CD4Memory
NS810_TTGCCACAATCG	Plasma
NS810_TTGCCTCAAAAT	Plasma
NS810_TTGCTAGCACGA	Plasma
NS810_TTGCTGACCCGC	cDC
NS810_TTGCTGTGACCT	Plasma
NS810_TTGGATGATGTA	Plasma
NS810_TTGGATTGTACT	Plasma
NS810_TTGGGTTCTGAG	HSPC
NS810_TTGGTCGTAAGC	Plasma
NS810_TTGTACTGGTCA	Plasma
NS810_TTGTCTACCGAA	Plasma
NS810_TTGTCTATTAGA	cDC
NS810_TTGTTCCCAACG	Plasma
NS810_TTGTTCGCAAGC	cDC
NS810_TTTAAGTGCTAA	HSPC
NS810_TTTACCCTCAAA	Plasma
NS810_TTTACCGTATGA	cDC
NS810_TTTAGCTCACGC	Plasma
NS810_TTTAGGCTGGAC	Plasma
NS810_TTTAGGTAGGCA	Plasma
NS810_TTTAGTGAACAG	cDC
NS810_TTTAGTGTCGAT	cDC
NS810_TTTATACCACTG	HSPC
NS810_TTTATCCCCAAA	Plasma
NS810_TTTCAACAAGGC	HSPC
NS810_TTTCCGTCCAAC	Plasma
NS810_TTTCCTATCGGT	Plasma
NS810_TTTCGTGTCTAG	HSPC
NS810_TTTCTGGTAGTT	CD8Memory
NS810_TTTGAGTTAATA	HSPC
NS810_TTTGCAACCCCC	Plasma
NS810_TTTGGGAACATC	Plasma
NS810_TTTGGGATCGGT	HSPC
NS810_TTTGGGCCCATC	cDC
NS810_TTTGTCCGCGAT	Plasma
NS810_TTTTACCAGGGT	Plasma
NS810_TTTTAGTCTCTA	HSPC
NS810_TTTTCAGCAAGT	Plasma
NS810_TTTTGGGTCGTA	Plasma
NS810_TTTTGGTGTTCA	Plasma
NS810_TTTTTACATGCG	Plasma
NS810_TTTTTTATGGAA	cDC
NS810_TTTTTTGCACAG	Plasma
NS810_TTTTTTTTTTTT	Plasma
NW_AAAACGCACATT	CD4Memory
NW_AAAAGGATATTG	HSPC
NW_AAACTACAGCAT	Plasma
NW_AAACTCGGTGGC	cDC
NW_AAACTTGATCCC	Plasma
NW_AAAGCTCGACCT	HSPC
NW_AAAGGGATGCTC	Plasma
NW_AAATAGTAGAAG	Plasma
NW_AAATCCGCGCGG	Plasma
NW_AAATCCGTCCGT	Plasma
NW_AAATCGTTATAC	Plasma
NW_AAATCTTCAGTA	Plasma
NW_AAATTAAAAAGT	Plasma
NW_AACAAGAGCCCT	cDC
NW_AACAAGGCGAAA	Plasma
NW_AACACGTCGCCC	HSPC
NW_AACACTCTCCAG	HSPC
NW_AACAGTCATTCG	HSPC
NW_AACAGTGCGATT	Plasma
NW_AACCATGCTAGC	Plasma
NW_AACCATTTTTTG	NKT
NW_AACCCGGACCCA	CD4Memory
NW_AACCTAATGGCA	Plasma
NW_AACCTTTGCGCT	HSPC
NW_AACGCGGGGCAG	Plasma
NW_AACGTCTCAACG	cDC
NW_AACTTCTTATTT	Plasma
NW_AACTTGTGGTAT	cDC
NW_AAGAAATGAACT	CD4Memory
NW_AAGACTCTTTTG	HSPC
NW_AAGAGCTAAAGC	HSPC
NW_AAGAGGCTCCTA	Plasma
NW_AAGCTAGCGTTG	Plasma
NW_AAGGCTGGTGTC	Plasma
NW_AAGGTACTGTGT	Plasma
NW_AAGGTGAAAACG	cDC
NW_AAGTCATCTCAA	Plasma
NW_AAGTCCGAGAAG	Plasma
NW_AAGTCTGCGCCG	HSPC
NW_AAGTGGGTCAAT	Plasma
NW_AAGTTAGTCGTG	cDC
NW_AAGTTCACAATT	HSPC
NW_AAGTTCTTAGGA	Plasma
NW_AATAGATAAGCT	Plasma
NW_AATAGGCGCGAG	HSPC
NW_AATCAATAGTAC	Plasma
NW_AATCAATCGGAA	Plasma
NW_AATCGCGTTCAC	HSPC
NW_AATCTTCCCTTG	HSPC
NW_AATTAAGGAGTC	Plasma
NW_AATTCGCAAAGA	CD4Memory
NW_AATTTAAGAGTC	CD8Memory
NW_AATTTAGAGCAG	Plasma
NW_AATTTGCTGATT	HSPC
NW_ACAAATGATGCT	HSPC
NW_ACAACATAGATT	Plasma
NW_ACAACGAGGAAA	Plasma
NW_ACAACGTAGCGA	Plasma
NW_ACACCATCGCCG	Plasma
NW_ACATCGGACACG	Plasma
NW_ACATGATCGCCC	Plasma
NW_ACATGTAGGTAG	CD4Memory
NW_ACATGTGAGTAA	Mono
NW_ACATTCTTAGAA	CD8Naive
NW_ACCAAATCTGCA	Plasma
NW_ACCATAGACGTC	Plasma
NW_ACCATTGCCGCC	HSPC
NW_ACCCAAAGAGTC	HSPC
NW_ACCCAGGATACG	Plasma
NW_ACCCGTATATTT	HSPC
NW_ACCCGTCAGAAC	HSPC
NW_ACCCTAGTCGCA	HSPC
NW_ACCGCCGATTTA	Plasma
NW_ACCGGATGTTAG	Plasma
NW_ACCGTAGGCACG	cDC
NW_ACCTCTCGCGAT	HSPC
NW_ACCTTTGACGCC	cDC
NW_ACGAAGTCACAC	Plasma
NW_ACGACCGGCGAA	cDC
NW_ACGATCGGCCAT	Plasma
NW_ACGATGTCGGGG	Plasma
NW_ACGCCTGTGTCG	HSPC
NW_ACGGCAATCCTC	Plasma
NW_ACGGGTGCTAGT	Plasma
NW_ACGTGCCTAGTC	NKT
NW_ACTACACCGAGT	cDC
NW_ACTAGGGCGACC	Plasma
NW_ACTATCACAGGG	HSPC
NW_ACTCACTGTCTT	Plasma
NW_ACTCCCACGTCA	Plasma
NW_ACTCCGCGCTAC	Plasma
NW_ACTCGCGAAGGC	Plasma
NW_ACTCGGTAGGGG	HSPC
NW_ACTCTGGGACTT	Plasma
NW_ACTGAAAGGCCG	cDC
NW_ACTGGAGTGGGA	cDC
NW_ACTGGTCTCTAT	Plasma
NW_ACTTACGTGTGC	HSPC
NW_AGAACAATTGTG	Plasma
NW_AGAATAATTAGT	HSPC
NW_AGACAGCTTCCC	Plasma
NW_AGACATAAAGTT	Plasma
NW_AGACATACGAGA	Plasma
NW_AGACATCTCGAA	Plasma
NW_AGACGACTATCG	CD4Memory
NW_AGACTAAGCAGG	Plasma
NW_AGACTAGACACT	Plasma
NW_AGAGATCGCAAC	Plasma
NW_AGAGATTTGTAG	HSPC
NW_AGAGCATTGGCT	CD4Memory
NW_AGAGGAGAACTT	Plasma
NW_AGAGGCTAGTCG	CD4Memory
NW_AGAGTCAGAATA	cDC
NW_AGATACAGTGCC	cDC
NW_AGCAAAGTGGCA	HSPC
NW_AGCACTCGAACG	HSPC
NW_AGCCGCCCCCAT	Plasma
NW_AGCCGGTTTCCT	Plasma
NW_AGCCTGCGAGGG	Mono
NW_AGCCTGTACACT	Plasma
NW_AGCGAGTTGGGC	Plasma
NW_AGCGATCCCCAG	Plasma
NW_AGCGGACGGTAT	Plasma
NW_AGCGTAGCATTG	Plasma
NW_AGCTCGGCTTGC	CD8Memory
NW_AGCTGGACGAAA	HSPC
NW_AGGAGGTTCGTT	cDC
NW_AGGATTGCTATA	Plasma
NW_AGGCACACCCAT	HSPC
NW_AGGCACTTACGG	Plasma
NW_AGGCAGTGCGAG	HSPC
NW_AGGCGAAGAAAA	Plasma
NW_AGGCTCTTATTT	Plasma
NW_AGGGAGAAATTA	Plasma
NW_AGGGGTTGGGGA	Plasma
NW_AGTAATCTTCAA	HSPC
NW_AGTACAAGCCCT	Plasma
NW_AGTATCAGGCGA	pDC
NW_AGTCATAAGCGT	cDC
NW_AGTCCCCTATCA	Plasma
NW_AGTCGCTACATC	cDC
NW_AGTCTGGAGAAA	cDC
NW_AGTTGCGACCAA	Plasma
NW_AGTTTCCCTCTT	Plasma
NW_ATAAACGTAGGC	Plasma
NW_ATACAGTGACGG	CD4Memory
NW_ATACCCGGTGGC	HSPC
NW_ATAGATAGCCTT	Plasma
NW_ATAGTTGAAAAA	Plasma
NW_ATATATGCTCAG	Plasma
NW_ATCAAAACTACT	CD4Memory
NW_ATCAGGACACGT	Plasma
NW_ATCCCACACGGT	HSPC
NW_ATCCGTGAGTGA	Plasma
NW_ATCGATGCGTCA	CD8Naive
NW_ATCGCTGTTTAC	Plasma
NW_ATCTAGGCACGG	Plasma
NW_ATCTGCCATGAG	HSPC
NW_ATGACGTGCTAG	Plasma
NW_ATGCAACCCAGG	HSPC
NW_ATGCAAGGCCCC	CD4Memory
NW_ATGCAGCGAATT	HSPC
NW_ATGCCGCTAAGT	Plasma
NW_ATGCGCGTGCCA	cDC
NW_ATGCTATCACCC	HSPC
NW_ATGCTCTTCTGT	B
NW_ATGGCCCGATCA	HSPC
NW_ATGGGCTGGTCT	Plasma
NW_ATGGTTCTCCGG	CD4Memory
NW_ATGTATAAACAT	CD4Memory
NW_ATGTCGATCAGG	Plasma
NW_ATGTGCCAGCGT	HSPC
NW_ATTAAGTGCGCG	Plasma
NW_ATTACTGTCTGA	Plasma
NW_ATTATGACATTT	Plasma
NW_ATTCCCGCTAGC	HSPC
NW_ATTCCTCAGGAC	Plasma
NW_ATTCGATATCGG	Plasma
NW_ATTCTAGTACGT	HSPC
NW_ATTCTCTACGCC	Plasma
NW_ATTGCAGCTTAG	Plasma
NW_ATTGGACAAACT	Plasma
NW_ATTGGGCCGTTT	Plasma
NW_ATTTAAGTTTCC	HSPC
NW_ATTTAGGGAAAT	Plasma
NW_ATTTTCAAGTGA	HSPC
NW_CAAACCTTTACC	CD4Memory
NW_CAAAGGAGGAAG	HSPC
NW_CAACAGCCTGTA	Plasma
NW_CAACGAAGTCTG	Plasma
NW_CAACGATCTTCG	Plasma
NW_CAACGTGCTGTT	Plasma
NW_CAAGCGTGATAT	Plasma
NW_CAAGGAACAGAC	Plasma
NW_CAATCCCAAGTG	HSPC
NW_CACAACAAAGAG	HSPC
NW_CACACGGGATGT	Plasma
NW_CACAGCGCTCGG	Plasma
NW_CACCAACTTCCC	Plasma
NW_CACCACCCGCTC	Plasma
NW_CACCACTGGAAG	Plasma
NW_CACCACTTGCCT	Plasma
NW_CACCGCTACGTG	Plasma
NW_CACCGGCTACAT	Plasma
NW_CACCTATCAGCA	Plasma
NW_CACCTTACTCTG	HSPC
NW_CACGACCGGTAT	Plasma
NW_CACGTACCCACA	pDC
NW_CAGAATCAGGAT	HSPC
NW_CAGACTATGTGA	CD8TermExh
NW_CAGATTCAGGAA	Plasma
NW_CAGCGTACAACG	Plasma
NW_CAGGAATGATGA	Plasma
NW_CAGGCAGAACGT	HSPC
NW_CAGGGATGAAAT	Plasma
NW_CAGGGGTCCATG	Plasma
NW_CAGTCTCTTTGA	pDC
NW_CATAAAATAGAT	Plasma
NW_CATAATCACATC	Plasma
NW_CATAATCGGTGC	cDC
NW_CATACGTACCTC	HSPC
NW_CATAGGAATGCC	Plasma
NW_CATCCCGTGAAT	Plasma
NW_CATCCTAGATGA	Plasma
NW_CATCGTGGCTTG	pDC
NW_CATGCGTGCTGT	HSPC
NW_CATGGGACCACC	CD4Memory
NW_CATGTTGTCCTT	Plasma
NW_CATTACGTCATT	Plasma
NW_CATTGGCACCTG	HSPC
NW_CCAATCTGTTTA	CD8TermExh
NW_CCAATGAGATAC	CD8Memory
NW_CCACACTTGAAA	Plasma
NW_CCACCCATGCAT	Plasma
NW_CCAGATCGGTCA	CD8Naive
NW_CCCAACGACGGG	cDC
NW_CCCAAGACCTTT	Plasma
NW_CCCAATAATGGT	Plasma
NW_CCCACCCGCGCC	Plasma
NW_CCCAGATCTGAA	cDC
NW_CCCATGTTGCGA	CD4Memory
NW_CCCCATAGTTCT	Plasma
NW_CCCGAATAATCA	CD8Memory
NW_CCCGACGGCCAT	HSPC
NW_CCCGAGTAAGTT	Plasma
NW_CCCGCTAGTACA	pDC
NW_CCCGCTCTCCTG	Plasma
NW_CCCGGCACCGGA	Plasma
NW_CCCGGTCTTGAG	Plasma
NW_CCCTAAGGGCTT	HSPC
NW_CCCTCATTTAAG	Plasma
NW_CCCTCTCAAGCT	HSPC
NW_CCCTCTTAGAGG	CD4Memory
NW_CCCTGTTTCATC	Plasma
NW_CCGAACGTCGGA	Plasma
NW_CCGACTAGTGGC	HSPC
NW_CCGATTGCGTTC	Plasma
NW_CCGCAACCCCTA	HSPC
NW_CCGGATATACGA	cDC
NW_CCGGGGTTGTCT	Plasma
NW_CCGGTCGACGAC	Plasma
NW_CCGTCCGTAGCG	Plasma
NW_CCGTCGATCTCT	Plasma
NW_CCGTTCCGACTT	Plasma
NW_CCTACCGACAGT	HSPC
NW_CCTAGCATAAGA	Plasma
NW_CCTATGACAGGT	CD8Naive
NW_CCTCAGGCCGGT	Plasma
NW_CCTCCCCACACG	Plasma
NW_CCTCCGGTTAAT	Plasma
NW_CCTCGTGAAAAA	HSPC
NW_CCTCTCGCCTTT	pDC
NW_CCTCTTCGGGCC	Plasma
NW_CCTGAGATATTG	Plasma
NW_CCTGAGCGTGGA	Plasma
NW_CCTGAGTGAACT	HSPC
NW_CCTGCAGCGATG	Plasma
NW_CCTTAGATGATG	Plasma
NW_CGAAGAGGATGA	HSPC
NW_CGAAGATGGGAA	HSPC
NW_CGAATTTTTCGG	CD8Memory
NW_CGACGCTATTAA	CD4Memory
NW_CGAGACTTAGAA	Plasma
NW_CGAGATTATGCT	cDC
NW_CGAGCAGGATCA	pDC
NW_CGAGCCTTCGCA	Plasma
NW_CGAGTTGCGAAT	Plasma
NW_CGATAGCCTTAA	Plasma
NW_CGATCAGATAGG	Plasma
NW_CGATCCTCCCTT	Plasma
NW_CGATGGCACGAC	Plasma
NW_CGCAGCAAAATC	Plasma
NW_CGCATCCTTCGA	Plasma
NW_CGCCAGGCTATA	HSPC
NW_CGCCCCAGCTTT	HSPC
NW_CGCCGCCGTGTT	HSPC
NW_CGCCGCTCGGAC	Plasma
NW_CGCCTTGCTCCT	CD8TermExh
NW_CGCGCGCGTTAT	Plasma
NW_CGCGCTCGTTGA	HSPC
NW_CGCGGTACTTTT	cDC
NW_CGCTAGCCTGAC	Plasma
NW_CGCTGTTCCAAG	HSPC
NW_CGGAGGCGTGGG	Plasma
NW_CGGAGTATGAAC	HSPC
NW_CGGAGTGATTTC	HSPC
NW_CGGCATACTTTC	HSPC
NW_CGGCCCGAGGGT	HSPC
NW_CGGCGGCTCGGT	Plasma
NW_CGGGAGGTATAA	CD8TermExh
NW_CGGGGCCGGAAC	Plasma
NW_CGGGGCGATAGC	Plasma
NW_CGGGTAGTGTGC	CD4Memory
NW_CGGGTATTGGCC	Plasma
NW_CGGGTCGACATC	CD4Memory
NW_CGGTCATTTTGC	CD4Memory
NW_CGGTCGGGAAAA	Plasma
NW_CGGTCTACGAAC	cDC
NW_CGGTGGTCCCAC	HSPC
NW_CGGTGTCGGGAG	Plasma
NW_CGTACCCGAGAC	cDC
NW_CGTAGCCAATTA	cDC
NW_CGTCAAGCGGGG	HSPC
NW_CGTCAATCACAT	pDC
NW_CGTCAGGCTCGA	Plasma
NW_CGTCATAGCCGG	Plasma
NW_CGTCATTACGAG	Plasma
NW_CGTCATTCATTA	Plasma
NW_CGTCGAAGGAAA	Plasma
NW_CGTCTCCGGGCA	CD4Memory
NW_CGTGTGAGAGTG	Plasma
NW_CGTTAAACACGC	CD4Memory
NW_CGTTCCTTCAAG	cDC
NW_CTAACCTTGAGG	Plasma
NW_CTAACGCATTGC	Plasma
NW_CTAATAGACGCA	CD8TermExh
NW_CTAATTCGAGGA	HSPC
NW_CTACACTTTAGG	Plasma
NW_CTAGCTATTAGT	CD4Memory
NW_CTATATCCCCGG	cDC
NW_CTATTGGCCGTA	Plasma
NW_CTCATGTTGTTC	Plasma
NW_CTCCAGCGGCTC	Plasma
NW_CTCCCCGTAGGT	cDC
NW_CTCCGGCAACCG	Plasma
NW_CTCGACCGAGAC	CD8Naive
NW_CTCGAGCCACCT	HSPC
NW_CTCGCGTTTGCG	HSPC
NW_CTCTAGGAGACC	HSPC
NW_CTCTAGTCACGC	Plasma
NW_CTCTATACCTGC	Plasma
NW_CTCTGTCGGGTC	ProB
NW_CTCTTACATCAC	CD4Memory
NW_CTGACCCATGTA	Plasma
NW_CTGATATTCCTG	Plasma
NW_CTGCCATTAGGG	HSPC
NW_CTGCGTGCTGCA	Plasma
NW_CTGCTCCCCGGG	CD4Memory
NW_CTGCTGGACGGG	HSPC
NW_CTGGAAAAATTG	Plasma
NW_CTGGATTCCTTC	Plasma
NW_CTGGCTGTATGT	HSPC
NW_CTGGGGCCTCAT	Plasma
NW_CTTACGGTATAG	Plasma
NW_CTTCCGCTCGCC	HSPC
NW_CTTCTGTGACTC	pDC
NW_CTTGAGGAGATC	HSPC
NW_CTTGAGGGAATG	Plasma
NW_CTTGCCGTGGTT	HSPC
NW_CTTGGCTAGCTA	HSPC
NW_CTTGGTATATAT	Plasma
NW_CTTTACGCGCCA	CD4Memory
NW_CTTTGGAGATAT	Plasma
NW_GAAACAGTACTC	Plasma
NW_GAAAGGCTGGCT	Plasma
NW_GAAATACTGGTC	cDC
NW_GAAATCGATTAG	Plasma
NW_GAACAGTTCCCT	cDC
NW_GAACATGGTGAA	HSPC
NW_GAACGGGTGCGC	cDC
NW_GAACGTTTTGCC	CD8TermExh
NW_GAACTCACAACC	HSPC
NW_GAAGCAGGTAGG	Plasma
NW_GAAGCGAGCCTG	CD4Memory
NW_GAAGCGCTCACG	HSPC
NW_GAAGTCGTTACA	Plasma
NW_GAATAGTCCTAG	cDC
NW_GAATATTCCTCT	Plasma
NW_GAATTACTTACA	HSPC
NW_GACATACAGCTC	Plasma
NW_GACCCACAAAAC	Plasma
NW_GACCGCAGACTT	Plasma
NW_GACCGCTCACTT	CD4Memory
NW_GACCTTCAGTTC	Plasma
NW_GACCTTTCAGAC	HSPC
NW_GACGGCGTCTTA	Plasma
NW_GACGGGCTAGTG	Plasma
NW_GACGTCCGAGAC	Plasma
NW_GACTTGACAGGA	CD4Memory
NW_GAGAAACGGAAG	HSPC
NW_GAGACATGATTA	CD4Memory
NW_GAGACCACAGCA	Plasma
NW_GAGACCATTACT	Plasma
NW_GAGAGAGTGCTA	Plasma
NW_GAGATCCAGATA	cDC
NW_GAGCACCATCTC	Plasma
NW_GAGCATTCCCAC	HSPC
NW_GAGCCGGGACAG	cDC
NW_GAGGGATTAGAT	HSPC
NW_GAGTACTAGTAC	HSPC
NW_GAGTCCCAGATT	CD8Memory
NW_GAGTCGGATATC	Plasma
NW_GAGTCTTTCTTT	HSPC
NW_GATAATATCTGC	Plasma
NW_GATACCCTTTGC	HSPC
NW_GATACGGGCTGA	HSPC
NW_GATACTGGTACG	Plasma
NW_GATACTGGTCTC	Plasma
NW_GATAGAGCACAA	Plasma
NW_GATAGCTAGACA	Plasma
NW_GATATCTTAGTT	HSPC
NW_GATCAATCGAGA	Plasma
NW_GATCCGACACTA	CD4Memory
NW_GATCGGACACGA	Plasma
NW_GATTAACGCCTC	HSPC
NW_GATTCGCGGCCT	Plasma
NW_GATTGAGATATG	Plasma
NW_GATTGATGCGTA	Plasma
NW_GATTGGAAGTCG	Plasma
NW_GCAAGTAGGGAC	Plasma
NW_GCACCAGTTTAA	Plasma
NW_GCACGAAACACA	Plasma
NW_GCACTTCCTCTG	CD8Memory
NW_GCAGAATTAAAG	Plasma
NW_GCAGAGGTGGAA	HSPC
NW_GCAGTCGCCCTG	Plasma
NW_GCATAAGGTATA	HSPC
NW_GCATCGACAGTC	Plasma
NW_GCATCTTGTCAT	Plasma
NW_GCATTAACATTT	Plasma
NW_GCATTACCCCTT	HSPC
NW_GCCAATACATTT	Plasma
NW_GCCAATTGACAC	CD4Memory
NW_GCCACAATGTCA	CD4Memory
NW_GCCAGACTGACT	ProB
NW_GCCAGTCGTACT	Plasma
NW_GCCATGTTTAAT	HSPC
NW_GCCCATCACAGT	Plasma
NW_GCCCGATCTGGG	Plasma
NW_GCCGCTACGGCC	Plasma
NW_GCCTAGCATGTT	Plasma
NW_GCGACCGAAGGC	HSPC
NW_GCGACCTCGTGA	Plasma
NW_GCGATCGAATAG	HSPC
NW_GCGCACATGCGG	Plasma
NW_GCGCACGTTGTG	Plasma
NW_GCGCCACTGTGA	Plasma
NW_GCGCGAATTACG	cDC
NW_GCGGAATACGTC	Plasma
NW_GCGGATTACATA	cDC
NW_GCGTACGACCGG	Plasma
NW_GCGTCATCGGGG	HSPC
NW_GCGTGGACGTCC	cDC
NW_GCGTTTGAGCTC	CD4Memory
NW_GCGTTTTAGATG	HSPC
NW_GCTAAATGGGCA	HSPC
NW_GCTACAAAGGGA	CD8TermExh
NW_GCTATTCGGCAG	Plasma
NW_GCTCAATCCGGA	HSPC
NW_GCTCAGAGTACG	Plasma
NW_GCTCATTGTGAG	Plasma
NW_GCTCGGAGCGAC	Plasma
NW_GCTGAAATCTGC	Plasma
NW_GCTGACCGTAGG	HSPC
NW_GCTGATACATTT	Plasma
NW_GCTGGATTCGGC	Plasma
NW_GCTGTTAAGAAT	Plasma
NW_GCTTGTCGAGCT	CD8Memory
NW_GGAAGCCCCTTC	Plasma
NW_GGAAGTATTGTC	Plasma
NW_GGACAAACATTG	Plasma
NW_GGACAGGCAGTC	HSPC
NW_GGAGGCTGGATA	Plasma
NW_GGAGGTTTAGAC	Plasma
NW_GGATAACTGAAC	Plasma
NW_GGATGCTTCGAA	Plasma
NW_GGATGTATTCTG	Plasma
NW_GGATTCAGTTGG	Plasma
NW_GGCAATACCATA	Plasma
NW_GGCACATACTAT	Plasma
NW_GGCAGTCTCTCT	HSPC
NW_GGCAGTTACCAA	HSPC
NW_GGCCCTACATTC	CD8Naive
NW_GGCCGACTCCGA	pDC
NW_GGCCTCATCATC	HSPC
NW_GGCGAATAGGGT	HSPC
NW_GGCGGCAGGCAG	HSPC
NW_GGCGGCTATATC	Plasma
NW_GGCGTTCCGCCA	Plasma
NW_GGCGTTGGTAAT	B
NW_GGCTCTCCTACA	CD4Memory
NW_GGCTTTATAACG	Plasma
NW_GGCTTTCCCGCG	Plasma
NW_GGGAAAAGTCCC	Plasma
NW_GGGAGTGTAGAA	Plasma
NW_GGGATGCGTAAC	Plasma
NW_GGGCATGTGGGC	Plasma
NW_GGGCCCAATTAG	Plasma
NW_GGGCGCGTATCA	pDC
NW_GGGGCATGCGCG	Plasma
NW_GGGGTCCCAATT	Plasma
NW_GGGTCCCGATCG	Plasma
NW_GGGTTCGCGGTA	Plasma
NW_GGTACAACCAGA	HSPC
NW_GGTACTGCATCG	CD4Memory
NW_GGTAGATACCCA	pDC
NW_GGTAGCGCGGTA	CD8TermExh
NW_GGTAGCTGAAGC	Plasma
NW_GGTATTCTGCCT	Plasma
NW_GGTCCCAAATCG	HSPC
NW_GGTGCACCCTGC	HSPC
NW_GGTGCGACGCGG	Plasma
NW_GGTGGGGGGCTG	cDC
NW_GGTTCGACACGG	Plasma
NW_GGTTGAATCCCA	Plasma
NW_GGTTTCTCTCTA	Plasma
NW_GTAAGTGCGGGT	Plasma
NW_GTAATCTACATA	Plasma
NW_GTAATGTTGAAC	Plasma
NW_GTAGAGAGCCTT	Plasma
NW_GTAGTGAGCGTT	Plasma
NW_GTATACGCCGTT	CD4Memory
NW_GTATGGGTAAAG	Plasma
NW_GTATTCATGATC	Plasma
NW_GTATTGTCACGA	Plasma
NW_GTCATTCTGAAG	CD8Naive
NW_GTCCAAACATGT	CD4Memory
NW_GTCCAAGGAGGC	Plasma
NW_GTCCCCTCTCTC	Plasma
NW_GTCCCTAGCTAT	HSPC
NW_GTCCGATTACCG	Plasma
NW_GTCCGCGTTCGT	Plasma
NW_GTCCGGGGGTAT	CD8Memory
NW_GTCGCAAACAGC	Plasma
NW_GTCGCAACATAC	pDC
NW_GTCGGACGTCCA	Plasma
NW_GTCGGTAATATG	CD8Naive
NW_GTCTAATCCACA	CD4Memory
NW_GTCTATGGACAT	CD8Naive
NW_GTCTTAGTCGCT	NK
NW_GTGATAATTCTA	Plasma
NW_GTGATCTCGGAG	HSPC
NW_GTGCAATATACC	Plasma
NW_GTGGGAACCGCA	Plasma
NW_GTGTACATTCTC	Plasma
NW_GTGTATCACTGC	Plasma
NW_GTGTCAACAATC	Plasma
NW_GTGTCTCAGCAA	Plasma
NW_GTGTTCAAGGCT	HSPC
NW_GTTACCGTACAT	Plasma
NW_GTTAGTACAGCA	Plasma
NW_GTTATTTCCCCA	HSPC
NW_GTTGACCGTCAA	Plasma
NW_GTTGCGGAGGGA	CD4Memory
NW_GTTGGATTCCCT	Plasma
NW_TAAAACCGAAAC	Plasma
NW_TAACAAGTCCCG	HSPC
NW_TAACAGACCGGA	Plasma
NW_TAACGAAAAACC	CD8Memory
NW_TAAGAGTTGGAA	Plasma
NW_TAAGGGGAAGTA	CD8Memory
NW_TAATACAAAAAA	Plasma
NW_TAATCAGCACGG	Plasma
NW_TACAACCTGCTA	Plasma
NW_TACAGCGGTTGA	Plasma
NW_TACATATTCGTC	Mono
NW_TACATCCGACAA	Plasma
NW_TACATCGTCTAG	HSPC
NW_TACCATAAATTT	Plasma
NW_TACCTGAGCACT	HSPC
NW_TACCTGTTCGTG	Plasma
NW_TACGCTAGCGTG	Plasma
NW_TACGGCGGGCTG	Plasma
NW_TACGGGGCAGGC	Plasma
NW_TACGTCTCCTCT	Plasma
NW_TACTTAAGTTTA	Plasma
NW_TAGAAAGCCCCA	pDC
NW_TAGCTCGTCTCT	Plasma
NW_TAGGATTGGAGT	Plasma
NW_TAGGCACTCTCT	Plasma
NW_TAGTTCTGGAAC	Plasma
NW_TATAACATGGCC	Plasma
NW_TATAATTAACGA	HSPC
NW_TATACAGGTACG	Plasma
NW_TATATACTGGTG	Plasma
NW_TATCCGGAGCAT	HSPC
NW_TATCGCGTACAT	Plasma
NW_TATGACAATTCA	Plasma
NW_TATGCTATGTAT	Plasma
NW_TATGTCTTCGTC	Plasma
NW_TATGTGGTGTGT	Plasma
NW_TATGTTGACGGT	Plasma
NW_TATTAAGTAAAT	Plasma
NW_TATTAAGTGCCC	HSPC
NW_TATTCGCGTGAA	pDC
NW_TATTGTACGCCT	Plasma
NW_TATTTCCCCACA	Plasma
NW_TCAAAAGGCATT	HSPC
NW_TCAAACGTGAAG	Plasma
NW_TCAAAGTTCCAG	cDC
NW_TCAACTCTGAGA	Plasma
NW_TCAAGCGAATTA	Plasma
NW_TCAATTACGTGA	CD8TermExh
NW_TCAGATCACCCA	Plasma
NW_TCAGCGTGAGTC	cDC
NW_TCAGGAGGCAAT	Plasma
NW_TCAGGGATGTTA	Plasma
NW_TCAGTTTGAAAC	Plasma
NW_TCATCAGTACGA	CD4Memory
NW_TCATCTCTAAAC	Plasma
NW_TCATGCGTGAGT	Plasma
NW_TCCAAATCCATC	Plasma
NW_TCCAATAAATAA	Plasma
NW_TCCAATATTGCA	Plasma
NW_TCCACCGACAAC	CD8Memory
NW_TCCACGAATCGC	Plasma
NW_TCCCAGGTTTGC	Plasma
NW_TCCCCTAATAGG	cDC
NW_TCCCGGGAACAG	HSPC
NW_TCCCTGCAGTGG	CD4Memory
NW_TCCGACTTCGCT	HSPC
NW_TCCGGCACAGGG	CD4Memory
NW_TCCTCTGTGCTT	HSPC
NW_TCGAAGCTTGGA	Plasma
NW_TCGATACCTCAG	Plasma
NW_TCGCGACACCAT	Plasma
NW_TCGCGATAGTGC	cDC
NW_TCGCGATCAGAC	Plasma
NW_TCGCTGAGATTT	CD4Memory
NW_TCGGCAGGCGGC	Plasma
NW_TCGGCATGTTCG	HSPC
NW_TCGGGTGCCTCT	CD4Memory
NW_TCGGGTTACTGT	Plasma
NW_TCGGTTATCTAG	HSPC
NW_TCGTAACCTAAC	HSPC
NW_TCTAATCATTCA	Plasma
NW_TCTACGTCAGCT	Plasma
NW_TCTAGACATCTA	Plasma
NW_TCTAGACTATAG	Plasma
NW_TCTATATGGTCG	cDC
NW_TCTATCACCGTT	Plasma
NW_TCTATGCTTACG	Plasma
NW_TCTCCACAAATG	Plasma
NW_TCTCCCTCCACC	Plasma
NW_TCTGCACGCGTA	CD8Memory
NW_TCTGCGTGTGGT	cDC
NW_TCTGGTGTGTTC	Plasma
NW_TCTGTAACTATT	HSPC
NW_TCTTACTCTTGA	Plasma
NW_TCTTTACGTTTT	cDC
NW_TGAAACTTTACA	cDC
NW_TGAAGGCGGCGG	Plasma
NW_TGAAGGGATGGA	cDC
NW_TGAATGGACCAT	HSPC
NW_TGACAACACAGG	Plasma
NW_TGACGTGCGCGC	cDC
NW_TGAGAATAGGCT	Mono
NW_TGAGATTCCTAA	Plasma
NW_TGAGGTCGTCTT	Plasma
NW_TGATCCGGGTTG	CD4Memory
NW_TGATCTCCCATC	HSPC
NW_TGATGGGCGTGC	CD8TermExh
NW_TGATTGATCGGC	Plasma
NW_TGCAAACGTAGA	CD4Memory
NW_TGCAACCTTAAA	Plasma
NW_TGCCAGCGTGAG	Plasma
NW_TGCCTGACTCTG	Plasma
NW_TGCGATTGTGCA	cDC
NW_TGGAAAACCCGG	Plasma
NW_TGGAACAGCGGC	Plasma
NW_TGGACACATTGC	Plasma
NW_TGGAGTCAGCAT	HSPC
NW_TGGATTCTTTTC	Plasma
NW_TGGCCTTCTCTT	Plasma
NW_TGGCGACTTGTG	Plasma
NW_TGGCTCTCTACG	Plasma
NW_TGGCTTCGACTC	HSPC
NW_TGGGACGTCTGA	Plasma
NW_TGGGCCAGCTCC	cDC
NW_TGGGGTTTGTCT	Plasma
NW_TGGGTGAATTCT	Plasma
NW_TGGTCACCCGGT	HSPC
NW_TGGTGCGTCTCA	cDC
NW_TGGTTCTGAAGC	Plasma
NW_TGTAGCTAGCTT	HSPC
NW_TGTCACCGGGCG	Plasma
NW_TGTCAGGCAGAC	Plasma
NW_TGTCGATTGACA	HSPC
NW_TGTCTGCTATCG	Plasma
NW_TGTTACCTCGCC	CD8Memory
NW_TGTTGTACCAGG	Plasma
NW_TTAACGGTCTTC	HSPC
NW_TTAAGGAGCCGC	Plasma
NW_TTACGTCAATTA	HSPC
NW_TTACTGAAGGTC	Plasma
NW_TTAGAATACATC	Plasma
NW_TTAGAATGTTCG	HSPC
NW_TTAGATGGTTCC	CD4Memory
NW_TTAGTCTAAGTT	Plasma
NW_TTAGTTTTACCT	Plasma
NW_TTATCACTAGGG	Plasma
NW_TTATTCGCGATC	Plasma
NW_TTCCAAAACGAG	HSPC
NW_TTCCCGCGTTTT	Plasma
NW_TTCCTCATGCGT	Plasma
NW_TTCGAGTCAGAC	Plasma
NW_TTCGATGGTATA	Plasma
NW_TTCGCTAGACGT	CD8Naive
NW_TTCGGACCCTCT	Plasma
NW_TTCGGATATCTC	Plasma
NW_TTCGTGTCCCAT	Plasma
NW_TTCGTTTTCTGA	Plasma
NW_TTCTAGACGTGG	cDC
NW_TTCTGTAGAGTC	cDC
NW_TTCTGTTAGTGT	Plasma
NW_TTGACACTTATT	Plasma
NW_TTGAGTAAATAA	Plasma
NW_TTGCCCTTTGTC	Plasma
NW_TTGCCGCAATAC	Plasma
NW_TTGCGCACGTTC	Plasma
NW_TTGGTCCGCACA	cDC
NW_TTGTCGATGAAC	Plasma
NW_TTGTGCTCTAGG	Plasma
NW_TTGTGGTGTACT	HSPC
NW_TTGTTGCAGTCA	CD8Memory
NW_TTTAACCTGCAA	Plasma
NW_TTTCAAAACAGT	CD4Memory
NW_TTTCCCTCAATA	Plasma
NW_TTTGCTGATTTT	CD8TermExh
NW_TTTTCCGCAGCT	Plasma
