cell	MaxPrediction
Normal_AAAAAAGGTTCC	CD8TermExh
Normal_AAAACAACGGGG	Doublets
Normal_AAAACCGAAACC	Doublets
Normal_AAAACGCGTGCC	CD8TermExh
Normal_AAAACGTATCGT	Doublets
Normal_AAAAGAGGATAG	cDC
Normal_AAAAGATCAATA	Plasma
Normal_AAAAGCAAACAG	Doublets
Normal_AAAAGGACTACA	Doublets
Normal_AAAATAGGCGGA	Plasma
Normal_AAACAATCATTT	Plasma
Normal_AAACAATGCTGG	Doublets
Normal_AAACACGTTGCC	CD4Memory
Normal_AAACAGAAAGCC	HSPC
Normal_AAACATCCAGCG	CD8TermExh
Normal_AAACATTCACGA	cDC
Normal_AAACCTGGGGCT	cDC
Normal_AAACGACGCTTT	Doublets
Normal_AAACGTCGCTCA	CD8TermExh
Normal_AAAGACACGCTG	Doublets
Normal_AAAGGCAGCTTA	CD4Memory
Normal_AAAGGGGTCTAC	HSPC
Normal_AAAGTATAGGCG	HSPC
Normal_AAAGTTTCTCCG	B
Normal_AAATAACATACT	Plasma
Normal_AAATAATATTCC	Plasma
Normal_AAATATTGGACT	Doublets
Normal_AAATATTTGCTT	CD4Memory
Normal_AAATCAATTGCG	Plasma
Normal_AAATCCCTTGAA	Plasma
Normal_AAATCGTGGGGA	cDC
Normal_AAATGCCATTCA	Doublets
Normal_AAATGCGGGTAT	Doublets
Normal_AAATTACTTTAT	CD8Naive
Normal_AAATTCACATAG	Plasma
Normal_AACAACCCGACA	Doublets
Normal_AACAACCGTTAA	Doublets
Normal_AACACAATTTAT	Plasma
Normal_AACACAGCTCCT	Doublets
Normal_AACACGCTCTAC	Doublets
Normal_AACAGTGTATAA	Plasma
Normal_AACATAATGGAG	HSPC
Normal_AACATCCATATT	Plasma
Normal_AACCACAACAGA	Doublets
Normal_AACCCACGTTGC	Doublets
Normal_AACCCAGATCCC	NK
Normal_AACCCGAGCCCT	HSPC
Normal_AACCCTCAACGA	Doublets
Normal_AACCGCTTCCTT	Doublets
Normal_AACCGTTACGCT	CD4Memory
Normal_AACGAGAGGAGC	CD4Memory
Normal_AACGCAATATGA	cDC
Normal_AACGCGCTAGAT	cDC
Normal_AACGCGCTGGCC	Doublets
Normal_AACGGAAACTAC	Doublets
Normal_AACGGTTTTACG	Plasma
Normal_AACGTAGGTAAC	Doublets
Normal_AACTAAAGCCTA	Plasma
Normal_AACTAGGACCTC	Plasma
Normal_AACTAGGGTTAT	cDC
Normal_AACTAGTCTTCT	Doublets
Normal_AACTATCCCAAC	HSPC
Normal_AACTCGGTAGAA	Doublets
Normal_AACTCTCCAGGG	Doublets
Normal_AACTGTGCTCCC	cDC
Normal_AACTTCACTCCT	Doublets
Normal_AAGAACAGCCAG	Doublets
Normal_AAGAATCCTATG	Plasma
Normal_AAGACACCTAGC	Plasma
Normal_AAGACCACTACG	Plasma
Normal_AAGACGCGCTAA	Doublets
Normal_AAGAGGCTAAAG	Doublets
Normal_AAGAGGTTAGTA	cDC
Normal_AAGATAGAGGTC	Doublets
Normal_AAGCCAGAGAGA	Plasma
Normal_AAGCCGATACCA	HSPC
Normal_AAGCGATACATC	Plasma
Normal_AAGCGGTTTGTC	Doublets
Normal_AAGCGTACACTG	Doublets
Normal_AAGCTTAGGCCA	Plasma
Normal_AAGGACATAATG	cDC
Normal_AAGGAGTACAGC	HSPC
Normal_AAGGATTCCGCT	Plasma
Normal_AAGGCAAGTTCG	Doublets
Normal_AAGGCCACGGAC	Plasma
Normal_AAGGCTGACGAG	Plasma
Normal_AAGGCTGGCTTC	Doublets
Normal_AAGGGAATAGAA	CD8Naive
Normal_AAGGGGCGCAAA	cDC
Normal_AAGGGTGATCTT	Doublets
Normal_AAGGGTTTCGAC	Plasma
Normal_AAGGTCAGGACG	Plasma
Normal_AAGGTCCGGTAG	Doublets
Normal_AAGGTGAGCCTG	HSPC
Normal_AAGTAAAGAATA	cDC
Normal_AAGTACAGAGAA	Plasma
Normal_AAGTCAGAAGGA	Doublets
Normal_AAGTCGCTCCGA	cDC
Normal_AAGTCTAGCTGT	HSPC
Normal_AAGTGATGTCGC	Plasma
Normal_AAGTGCCTCTGC	Plasma
Normal_AAGTGCGGAGTA	Doublets
Normal_AAGTGCTCTAAC	Doublets
Normal_AAGTGTAGTTGC	Plasma
Normal_AAGTTAGCCGTC	Doublets
Normal_AATAAACCAATG	Doublets
Normal_AATAAGTGTGAG	Doublets
Normal_AATAATATTAGC	Doublets
Normal_AATACGCACACG	Doublets
Normal_AATACGTCTGCA	Doublets
Normal_AATAGAGTCGTC	HSPC
Normal_AATAGCATTACC	Plasma
Normal_AATCAAAGGAAT	HSPC
Normal_AATCAACACAGT	cDC
Normal_AATCACTGGCAG	HSPC
Normal_AATCAGCTCGCC	Plasma
Normal_AATCATTGCGTT	Plasma
Normal_AATCCATCACGG	Doublets
Normal_AATCCCGGACGC	Plasma
Normal_AATCCTATGACT	Plasma
Normal_AATCCTCAGCTA	Doublets
Normal_AATCGTTTAGGA	Doublets
Normal_AATCTCACGAAC	CD4Memory
Normal_AATCTCCACCCA	Doublets
Normal_AATCTCCTGCCT	Doublets
Normal_AATCTCTTCTTG	Doublets
Normal_AATGATTCCCGG	Plasma
Normal_AATGATTCGCCC	Doublets
Normal_AATGATTGGAAA	Plasma
Normal_AATGCCATCTTG	Plasma
Normal_AATGCGCGTAGG	Plasma
Normal_AATGCTAACAGA	Doublets
Normal_AATGCTAATCTT	Doublets
Normal_AATGCTACTTAA	Doublets
Normal_AATGCTGCTCGC	Plasma
Normal_AATGGATACCCC	Doublets
Normal_AATGGCAACACT	CD4Memory
Normal_AATGGCGGTAAC	Plasma
Normal_AATGTAATTGCT	HSPC
Normal_AATGTTCGACCC	Doublets
Normal_AATGTTTTTCGT	Plasma
Normal_AATTAATCTTAA	Doublets
Normal_AATTAGCCCAAG	cDC
Normal_AATTCAACCGTC	Plasma
Normal_AATTCCAGAGGA	Doublets
Normal_AATTCGGGGCTG	cDC
Normal_AATTCTACTGAT	cDC
Normal_AATTGCCATGTG	Plasma
Normal_AATTGCGTACGT	Doublets
Normal_AATTGTGGGGTT	Plasma
Normal_AATTTAATCCGA	HSPC
Normal_ACAACAGCAATC	Doublets
Normal_ACAACCAGTGAC	Doublets
Normal_ACAACCCACCAT	cDC
Normal_ACAACCCCGGAA	Plasma
Normal_ACAACCGGGATG	Doublets
Normal_ACAACTAATTTT	Plasma
Normal_ACAAGCTAGAGG	Doublets
Normal_ACAAGGTTGGAA	Plasma
Normal_ACAATAAGTCTA	Doublets
Normal_ACAATCCTGGTC	HSPC
Normal_ACAATGCGCTTA	cDC
Normal_ACAATTTGCTCA	Plasma
Normal_ACACACCTTCAA	cDC
Normal_ACACACGCCCTG	Plasma
Normal_ACACCTTACTGG	CD4Memory
Normal_ACACCTTGATAC	cDC
Normal_ACACGACAACGC	Doublets
Normal_ACACGAGTGAGG	HSPC
Normal_ACACGTGACGAT	Doublets
Normal_ACACTAATTTGC	Plasma
Normal_ACACTATGCACG	Doublets
Normal_ACACTCAGTGAA	Doublets
Normal_ACACTCCCGGTC	CD4Memory
Normal_ACACTGAGTTGA	Plasma
Normal_ACACTTGCATAG	HSPC
Normal_ACAGATGGATCT	Doublets
Normal_ACAGCCTATGGA	Doublets
Normal_ACAGCTTCCCTA	Plasma
Normal_ACAGCTTTGCCG	Plasma
Normal_ACAGGCAGTCGC	Plasma
Normal_ACAGGCCCAGGT	Doublets
Normal_ACAGGTTCTCTC	Doublets
Normal_ACAGTATCTCCT	Plasma
Normal_ACAGTTGGTTAT	CD4Memory
Normal_ACATAGTTGTCT	Plasma
Normal_ACATATAGCCGC	Plasma
Normal_ACATCCATATCC	Plasma
Normal_ACATGCACTATC	Plasma
Normal_ACATGGAGGATT	HSPC
Normal_ACATGTTTTGGG	Doublets
Normal_ACATTGCAGTTA	cDC
Normal_ACATTGGCGCTA	Doublets
Normal_ACCAACCTGTAG	Plasma
Normal_ACCAAGTATATT	Plasma
Normal_ACCAATCGGCAC	cDC
Normal_ACCAATGACGTC	Plasma
Normal_ACCACATGTGTC	Doublets
Normal_ACCACGGCTGGC	Plasma
Normal_ACCACTGTGCTA	cDC
Normal_ACCAGCGCATAC	Plasma
Normal_ACCAGTTCCGGG	Doublets
Normal_ACCATCATGGCT	Doublets
Normal_ACCCAAATTACC	cDC
Normal_ACCCAGTACCAC	CD4Memory
Normal_ACCCATTGGCAG	Doublets
Normal_ACCCGCCCCTAC	Doublets
Normal_ACCCGGCCTACG	HSPC
Normal_ACCCTAACCACT	Doublets
Normal_ACCGACATTTCG	Plasma
Normal_ACCGAGAAAAGT	HSPC
Normal_ACCGAGGGTAAG	cDC
Normal_ACCGATTTTGAT	Plasma
Normal_ACCGCTCCTGGG	Doublets
Normal_ACCGCTTAAACG	Doublets
Normal_ACCGGAGCCCGA	Plasma
Normal_ACCGGGCGTTGA	Plasma
Normal_ACCGGGTTTTCG	Plasma
Normal_ACCGGTTCTTAG	CD4Memory
Normal_ACCGTAGCATAT	HSPC
Normal_ACCGTTTCATGT	HSPC
Normal_ACCGTTTGCGCA	CD8Memory
Normal_ACCTAAAGGGTC	Doublets
Normal_ACCTATCTATAT	cDC
Normal_ACCTATGTTGCT	Doublets
Normal_ACCTCGCAATAT	cDC
Normal_ACCTGTTCCATC	Plasma
Normal_ACCTTATTTGAT	Doublets
Normal_ACCTTCTACGAA	Plasma
Normal_ACCTTGTTTCAG	HSPC
Normal_ACCTTTAGGCGG	HSPC
Normal_ACGAACGAGTCG	Plasma
Normal_ACGACAAGCATT	Doublets
Normal_ACGACACGTGAG	Plasma
Normal_ACGACGATTGTC	CD4Memory
Normal_ACGACGCACTCA	Doublets
Normal_ACGAGCACACGG	Plasma
Normal_ACGAGCGCCGAC	Plasma
Normal_ACGAGCTCCGCT	Doublets
Normal_ACGAGGCTATTA	HSPC
Normal_ACGATGAAAACT	Plasma
Normal_ACGCAAGGGTCG	Plasma
Normal_ACGCAAGTTCAC	HSPC
Normal_ACGCAATCGGCA	CD8Memory
Normal_ACGCCATCAAAG	CD4Memory
Normal_ACGCCCAGTTGT	Doublets
Normal_ACGCGACCCTGC	Doublets
Normal_ACGCGAGCCTAG	CD4Memory
Normal_ACGCGGCCGCTG	Plasma
Normal_ACGCTCGTCATA	Doublets
Normal_ACGCTTCGAATA	HSPC
Normal_ACGGAGGCCGCA	Doublets
Normal_ACGGATTCATCC	Plasma
Normal_ACGGCGCTACGT	Doublets
Normal_ACGGCGCTTTAG	Doublets
Normal_ACGGGAATTATT	cDC
Normal_ACGGGACGGACC	Doublets
Normal_ACGGGGAGCGTA	Plasma
Normal_ACGGGGAGGTTG	Doublets
Normal_ACGGGTTCTTCG	Doublets
Normal_ACGGTATCTCCA	Doublets
Normal_ACGGTATTCTCC	Doublets
Normal_ACGGTCCTCGCT	Plasma
Normal_ACGGTCTGAAAA	Doublets
Normal_ACGGTGGCCCGA	HSPC
Normal_ACGGTTATCCTT	Plasma
Normal_ACGTACCCTTCG	Doublets
Normal_ACGTACCTGCCG	CD4Memory
Normal_ACGTACGGGAGT	Plasma
Normal_ACGTAGCACTGT	Doublets
Normal_ACGTCCATATAC	CD4Memory
Normal_ACGTCCCTTCTA	Doublets
Normal_ACGTCTAGGGGT	HSPC
Normal_ACGTCTGGACGG	cDC
Normal_ACTAAAAAAATG	Doublets
Normal_ACTAAAGCCAAT	Doublets
Normal_ACTAACCCCTGC	Doublets
Normal_ACTAATAGCCCA	Plasma
Normal_ACTACACGTCGT	Doublets
Normal_ACTACCCAAGGT	Doublets
Normal_ACTACCGACGGG	HSPC
Normal_ACTACGACCCCC	cDC
Normal_ACTACGATGAAT	Doublets
Normal_ACTACTATAGCG	HSPC
Normal_ACTACTCGAAAA	Doublets
Normal_ACTAGGGGTTCT	Plasma
Normal_ACTAGGTAGAGC	Plasma
Normal_ACTATCCGGCTC	Doublets
Normal_ACTCCATAACCC	HSPC
Normal_ACTCCCACCAGT	Plasma
Normal_ACTCCCCGCGCG	CD4Memory
Normal_ACTCGACTAGGC	Plasma
Normal_ACTCGTGGGGAG	Doublets
Normal_ACTCGTTGACTG	Plasma
Normal_ACTCTGCATTGG	Plasma
Normal_ACTGAGGAGTGG	Plasma
Normal_ACTGATGCCACG	Doublets
Normal_ACTGATTAAACT	Doublets
Normal_ACTGGAACGAGA	HSPC
Normal_ACTGTAGCACTC	Doublets
Normal_ACTGTTCCACTA	Doublets
Normal_ACTTACCCAAGT	HSPC
Normal_ACTTACTTCACC	Doublets
Normal_ACTTAGAACCAC	Plasma
Normal_ACTTCACTTCAC	Plasma
Normal_ACTTCGGAATCA	Plasma
Normal_ACTTCGTCTTCA	Plasma
Normal_ACTTCTGCGAGG	cDC
Normal_ACTTGCGGCAGG	cDC
Normal_ACTTGGTTAATA	Doublets
Normal_ACTTGTAAAAGC	cDC
Normal_ACTTGTTTGCGA	Plasma
Normal_ACTTTACCGAAT	CD8Naive
Normal_ACTTTGGTCATA	Doublets
Normal_AGAAAGATAGGT	cDC
Normal_AGAAAGCACTTT	Doublets
Normal_AGAAAGCCGGAT	Doublets
Normal_AGAAAGGACTAC	Doublets
Normal_AGAAAGGTTGGA	Doublets
Normal_AGAACGAAGAAC	CD4Memory
Normal_AGAACTAAAATA	Plasma
Normal_AGAAGCCTACTA	Doublets
Normal_AGAATCCTTTGG	Doublets
Normal_AGAATTCGCTAG	Plasma
Normal_AGAATTTTCGGT	Doublets
Normal_AGACATTGAATT	cDC
Normal_AGACCGAGACTT	Plasma
Normal_AGACCGCAAACA	Doublets
Normal_AGACTCATTTTC	Plasma
Normal_AGACTGCAGTAT	Doublets
Normal_AGACTTTACGGC	CD4Memory
Normal_AGAGACGTGGAG	Doublets
Normal_AGAGGAACTCTT	pDC
Normal_AGAGGACCCCTA	Plasma
Normal_AGAGGCGAGGCG	Doublets
Normal_AGAGGTTACATA	Plasma
Normal_AGAGGTTGAAAT	HSPC
Normal_AGAGTATAGACG	Plasma
Normal_AGAGTCAGACCT	Plasma
Normal_AGAGTCAGGGTG	Plasma
Normal_AGAGTGTTAATG	cDC
Normal_AGAGTTGGAACC	HSPC
Normal_AGAGTTGGCCGC	HSPC
Normal_AGATCCCAGCAA	cDC
Normal_AGATCCTAATTG	Doublets
Normal_AGATCTCCACTG	CD4Memory
Normal_AGATGACGTATT	Plasma
Normal_AGATGGAGGGTG	Plasma
Normal_AGATTGGAACCA	cDC
Normal_AGCAATGAGTAA	Doublets
Normal_AGCACCGGAAGA	HSPC
Normal_AGCACTAGAAGA	HSPC
Normal_AGCAGATCCTAT	Plasma
Normal_AGCAGCAGGGTC	HSPC
Normal_AGCAGGGGCTTG	HSPC
Normal_AGCAGGTTCGTC	Doublets
Normal_AGCATCAGCCCG	CD8TermExh
Normal_AGCATCTTAGGA	cDC
Normal_AGCATGACGGCC	Doublets
Normal_AGCATGCACAAC	Plasma
Normal_AGCATGCGAAAC	Plasma
Normal_AGCATGGATCGT	Plasma
Normal_AGCCACAGGTCA	Doublets
Normal_AGCCAGCCATCA	Doublets
Normal_AGCCATTTCTTC	Doublets
Normal_AGCCCACACGCA	Doublets
Normal_AGCCCATACAGT	CD4Memory
Normal_AGCCGAGCCCGC	CD4Memory
Normal_AGCCGCGCAGAG	CD8TermExh
Normal_AGCCGTGTGCTG	HSPC
Normal_AGCCGTGTTGTC	Plasma
Normal_AGCGATCGTCGT	Plasma
Normal_AGCGCCATTTTA	Doublets
Normal_AGCGCTGAACGT	Plasma
Normal_AGCGGAGCTCGG	Doublets
Normal_AGCGGCTCAGCT	HSPC
Normal_AGCGGTATCATA	Plasma
Normal_AGCGGTGTCTAC	Doublets
Normal_AGCGTACGACCA	CD4Memory
Normal_AGCTAACTATAA	Doublets
Normal_AGCTAAGTATCG	Plasma
Normal_AGCTACCGTGAG	cDC
Normal_AGCTCTTACGAC	HSPC
Normal_AGCTGGTAAGGA	HSPC
Normal_AGCTTATAATAG	Plasma
Normal_AGCTTTTGACCC	Doublets
Normal_AGGAAAATGTCG	Plasma
Normal_AGGACTAAGCAA	Plasma
Normal_AGGACTCACTTC	Plasma
Normal_AGGACTCCGTGC	Doublets
Normal_AGGACTCTCTCC	Doublets
Normal_AGGACTGAAAAT	Plasma
Normal_AGGAGCGCCCGG	Plasma
Normal_AGGAGCGGGCCC	Plasma
Normal_AGGAGGGCGCTG	Doublets
Normal_AGGAGGGGATAG	Plasma
Normal_AGGAGTCCATGT	Plasma
Normal_AGGATCATCCAT	Doublets
Normal_AGGATCCGTATC	Doublets
Normal_AGGATGTTATCA	Doublets
Normal_AGGATGTTGGCC	Doublets
Normal_AGGATTTAGGAA	Doublets
Normal_AGGCACCAACGA	cDC
Normal_AGGCACCGTTTC	Doublets
Normal_AGGCCAAAAAGG	Doublets
Normal_AGGCCATAGGAT	Plasma
Normal_AGGCCCAATCCG	CD8Naive
Normal_AGGCCTAGGGCG	HSPC
Normal_AGGCGACCGGAA	Doublets
Normal_AGGCGCAGTGTC	Doublets
Normal_AGGCGCCCGCTA	Plasma
Normal_AGGCGTGTTCCG	CD8Naive
Normal_AGGCGTTACCTG	Plasma
Normal_AGGCTAGCTACA	Plasma
Normal_AGGCTATGTTCC	Doublets
Normal_AGGCTCATTAGA	Plasma
Normal_AGGCTCTACGTC	CD4Memory
Normal_AGGCTGCCGCCG	Doublets
Normal_AGGGAAAGTTGT	CD8TermExh
Normal_AGGGACGAAACT	Doublets
Normal_AGGGCAAAAGAG	Plasma
Normal_AGGGCCATAGGG	Doublets
Normal_AGGGCCCCCGAT	HSPC
Normal_AGGGCTGTGACA	Plasma
Normal_AGGGCTTATACG	Doublets
Normal_AGGGGCACGGGA	Doublets
Normal_AGGGGCAGGTCA	Doublets
Normal_AGGGGGCAAATA	cDC
Normal_AGGGTCACCCGG	Doublets
Normal_AGGGTCCTTGTC	Doublets
Normal_AGGGTGGATTAC	Plasma
Normal_AGGGTGTCACGA	Doublets
Normal_AGGGTGTTGTTG	Doublets
Normal_AGGGTTAAACAC	CD8TermExh
Normal_AGGTAGCCCCTA	Doublets
Normal_AGGTCTGACTGA	Doublets
Normal_AGGTGGGTTCGT	Plasma
Normal_AGGTGTCTAAGC	Doublets
Normal_AGGTTCACGACA	Doublets
Normal_AGGTTGAATGAC	CD4Memory
Normal_AGGTTGGGCAAA	Plasma
Normal_AGGTTTGATCTC	Doublets
Normal_AGTACGGAGAAG	Doublets
Normal_AGTACGGCTTTG	HSPC
Normal_AGTACTGGGCCA	Doublets
Normal_AGTACTGTCACG	Doublets
Normal_AGTAGACTGAGG	Doublets
Normal_AGTATTCTTAGC	cDC
Normal_AGTCAAAGTTGC	HSPC
Normal_AGTCAACCCTAT	Plasma
Normal_AGTCATTCGGAC	HSPC
Normal_AGTCCAACTGGT	Doublets
Normal_AGTCCCGGGACA	HSPC
Normal_AGTCCGGTCTAA	Plasma
Normal_AGTCCTGCTTGA	Doublets
Normal_AGTCCTTGATCC	CD8TermExh
Normal_AGTCGAAAAACG	Doublets
Normal_AGTCGCGGCATC	Plasma
Normal_AGTCTTGACTTT	Doublets
Normal_AGTCTTTCACCC	Doublets
Normal_AGTCTTTGTTCC	Plasma
Normal_AGTGCAACTTTA	Doublets
Normal_AGTGCGGGACGT	cDC
Normal_AGTGGGATGCCC	Doublets
Normal_AGTGGGGACTTC	CD4Memory
Normal_AGTGGGTTAGCA	Doublets
Normal_AGTGTCACGGCA	Doublets
Normal_AGTGTCAGGGCC	Doublets
Normal_AGTGTCCATGCC	Doublets
Normal_AGTGTGCAGCGC	CD4Memory
Normal_AGTGTTGTCAAA	Doublets
Normal_AGTGTTTCAAGA	Doublets
Normal_AGTTAAGAGTGG	Plasma
Normal_AGTTAGTCTACC	Doublets
Normal_AGTTCAGTTACA	cDC
Normal_AGTTCCGACCGT	Doublets
Normal_AGTTCCGGATGA	Plasma
Normal_AGTTCCTATCGT	Doublets
Normal_AGTTCTCGTGCG	CD4Memory
Normal_AGTTCTGGGCAG	Doublets
Normal_AGTTGAGGCACG	Plasma
Normal_AGTTGATTTATA	cDC
Normal_AGTTGCGACCGC	Doublets
Normal_AGTTGCGTTTCT	CD8TermExh
Normal_AGTTGTACTTAT	B
Normal_AGTTTAGATTCT	Plasma
Normal_AGTTTCATTTCT	Plasma
Normal_AGTTTGGCCTAG	Doublets
Normal_ATAAAAACTTAC	Plasma
Normal_ATAAAATTGGGC	Plasma
Normal_ATAAAGAGAGAT	pDC
Normal_ATAAATTCTGCT	HSPC
Normal_ATAACCATGAAT	Plasma
Normal_ATAACCTAACGG	Doublets
Normal_ATAAGCTTACTG	Doublets
Normal_ATAATACGCTCA	HSPC
Normal_ATAATAGTGCAA	Plasma
Normal_ATAATGAGTCGC	Plasma
Normal_ATAATGCCCAGA	Plasma
Normal_ATACAGTGCCTA	Doublets
Normal_ATACATGTAGGC	HSPC
Normal_ATACCATCTTCG	Plasma
Normal_ATACCGAGTCGC	Doublets
Normal_ATACCGCGAGCG	Plasma
Normal_ATACCTCGTTGG	Doublets
Normal_ATACGATATGCG	Doublets
Normal_ATACGCCATTCT	cDC
Normal_ATACGGCGATCC	cDC
Normal_ATACGTCTCGAT	Plasma
Normal_ATACTAATACGT	Doublets
Normal_ATACTACTATGT	Doublets
Normal_ATACTCAGATAT	Plasma
Normal_ATACTCCCTGCA	HSPC
Normal_ATACTGACTGCC	Doublets
Normal_ATACTTCCCGGT	Doublets
Normal_ATAGCGAGATCG	CD4Memory
Normal_ATAGCTATGCCC	Doublets
Normal_ATAGGATGCGCA	Plasma
Normal_ATAGGGATTTCG	cDC
Normal_ATAGGGTCTTGA	Doublets
Normal_ATAGTAGATCCT	HSPC
Normal_ATAGTAGCACTA	HSPC
Normal_ATAGTGCCAAAG	Plasma
Normal_ATAGTTAGGGCA	CD4Memory
Normal_ATATAAGGCTCG	cDC
Normal_ATATAGGATCGG	Plasma
Normal_ATATAGTCTTAT	Doublets
Normal_ATATCACGGGCA	Plasma
Normal_ATATCCAACTCA	Plasma
Normal_ATATCCGTGTTT	Plasma
Normal_ATATCGTGATCT	Plasma
Normal_ATATCTTTACAG	Plasma
Normal_ATATGGGCTGTC	Plasma
Normal_ATATTAGACTCA	Doublets
Normal_ATCAAGCTAGGT	CD4Memory
Normal_ATCAATAGACGC	Doublets
Normal_ATCAATCATTAG	CD4Memory
Normal_ATCACGGCCTGA	Doublets
Normal_ATCAGATGGACA	CD4Memory
Normal_ATCAGGTGGCTG	Plasma
Normal_ATCAGTGCAGCC	Plasma
Normal_ATCATAGAAGCG	cDC
Normal_ATCATGAACGAA	Doublets
Normal_ATCCACAGGGTC	Plasma
Normal_ATCCACGGCCTC	Doublets
Normal_ATCCACGTAACT	HSPC
Normal_ATCCAGCCGATG	CD4Memory
Normal_ATCCCCTCTTTT	CD8TermExh
Normal_ATCCCGTGTAAC	Plasma
Normal_ATCCGAATACGG	CD4Memory
Normal_ATCCGGCAAACT	CD4Memory
Normal_ATCCGGGAAACG	HSPC
Normal_ATCCGGGTGCGC	Plasma
Normal_ATCCGTAACCTG	CD8Memory
Normal_ATCCTAAATCTG	CD4Memory
Normal_ATCGAATGTGCG	Plasma
Normal_ATCGAGGTTTCG	Plasma
Normal_ATCGCAAGGCAA	CD4Memory
Normal_ATCGCGAATCAA	Plasma
Normal_ATCGGCACCTGC	Doublets
Normal_ATCGGTAGTCCC	cDC
Normal_ATCGGTATGGAC	Doublets
Normal_ATCGTATTGACC	NK
Normal_ATCGTTCAGCAG	cDC
Normal_ATCGTTCTAAAG	Plasma
Normal_ATCTCTCTCTGC	Plasma
Normal_ATCTGAAGGAAC	CD4Memory
Normal_ATCTGGGCATGG	Doublets
Normal_ATGAAACAAGCC	CD4Memory
Normal_ATGAAGACGTAC	Doublets
Normal_ATGAAGCATTAG	cDC
Normal_ATGAATAGGAAA	Plasma
Normal_ATGACGTAACGA	Plasma
Normal_ATGACGTAATGC	Plasma
Normal_ATGAGGCTCGAG	Plasma
Normal_ATGAGTATTCCC	Doublets
Normal_ATGAGTTCCACG	cDC
Normal_ATGATAAGTACC	Plasma
Normal_ATGATCTTTGTA	CD8Naive
Normal_ATGATGCTACCA	CD4Memory
Normal_ATGCAACCTTCG	HSPC
Normal_ATGCAAGGTTAG	CD4Memory
Normal_ATGCAATACGCC	cDC
Normal_ATGCACAAACTG	Doublets
Normal_ATGCACGGCAAC	Doublets
Normal_ATGCAGCCACCG	Plasma
Normal_ATGCCGGCGGGC	Plasma
Normal_ATGCCTGTCGTT	cDC
Normal_ATGCCTGTGAAG	HSPC
Normal_ATGCGAACAGTA	Plasma
Normal_ATGCGACCGCCA	HSPC
Normal_ATGCGAGCCTAA	Doublets
Normal_ATGCGAGCGAAC	cDC
Normal_ATGCTCCGCGCT	HSPC
Normal_ATGGAAAGCAGA	Doublets
Normal_ATGGAAATAGGA	Doublets
Normal_ATGGACATTATA	Plasma
Normal_ATGGCTCATCGC	Plasma
Normal_ATGGGCATATGT	Plasma
Normal_ATGGTTGTACTC	Doublets
Normal_ATGGTTTCAGTA	cDC
Normal_ATGTAAACTAAT	CD4Memory
Normal_ATGTAATAGAAC	Plasma
Normal_ATGTAGCATTTC	CD4Memory
Normal_ATGTCCGCAAAA	Plasma
Normal_ATGTCGGCGACA	Doublets
Normal_ATTAACCACCTG	B
Normal_ATTAATATCACC	Plasma
Normal_ATTAGCACCAAT	cDC
Normal_ATTATAGGGACA	Plasma
Normal_ATTATGATTTAG	Plasma
Normal_ATTATGTCCTGT	Plasma
Normal_ATTCAGCACCGG	CD4Memory
Normal_ATTCAGCGCGAC	Plasma
Normal_ATTCATGGCTTC	CD4Memory
Normal_ATTCCAAGTGAA	Doublets
Normal_ATTCGAGGCCTG	Plasma
Normal_ATTCGCATCGGC	Doublets
Normal_ATTCGGGCATCT	Plasma
Normal_ATTCTCCTGGAA	Plasma
Normal_ATTCTGAGTATT	Doublets
Normal_ATTGACATGATA	Doublets
Normal_ATTGACTAAATT	Doublets
Normal_ATTGCAGATTTT	Plasma
Normal_ATTGCAGTAGAT	CD4Memory
Normal_ATTGCTGTTCGA	Doublets
Normal_ATTGCTTCGGGG	Doublets
Normal_ATTGTCGGTGAT	Plasma
Normal_ATTGTCTTCATA	Doublets
Normal_ATTGTGACATCC	HSPC
Normal_ATTTAATCTTCG	Doublets
Normal_ATTTAATGCGGT	Doublets
Normal_ATTTACACTCAG	Plasma
Normal_ATTTAGCGTTAA	Plasma
Normal_ATTTAGCTAGCT	Doublets
Normal_ATTTAGTATTCA	cDC
Normal_ATTTATGCCGTT	Doublets
Normal_ATTTCACGATAC	Doublets
Normal_ATTTCATACTAA	Doublets
Normal_ATTTCCAAGTCG	Doublets
Normal_ATTTCCCAGAGG	Doublets
Normal_ATTTGGCATGCT	Doublets
Normal_ATTTGGGCAGAT	Plasma
Normal_ATTTGTAATTAT	Doublets
Normal_ATTTTAAAGATC	Plasma
Normal_ATTTTAAGATAA	Plasma
Normal_ATTTTACGAGTA	Doublets
Normal_ATTTTAGTCTTG	cDC
Normal_ATTTTATAAATA	cDC
Normal_ATTTTCAGGGGC	Doublets
Normal_ATTTTGGCTGAG	cDC
Normal_CAAAAATTTTGC	CD4Memory
Normal_CAAACGCGAAGG	Plasma
Normal_CAAACGCGGTGC	Doublets
Normal_CAAACGTTATAC	CD4Memory
Normal_CAAACTGCTTTG	Doublets
Normal_CAAACTTTTATT	Plasma
Normal_CAAAGCCGAAGA	cDC
Normal_CAAAGCGCCTTC	Plasma
Normal_CAAAGGACCCCT	cDC
Normal_CAAAGTAGGGCT	Plasma
Normal_CAAATCTCAGAA	Plasma
Normal_CAAATGCCCATC	Doublets
Normal_CAAATTAGGATG	Plasma
Normal_CAACACGAAGAA	pDC
Normal_CAACACTCTTAT	Doublets
Normal_CAACAGCCCTAT	Plasma
Normal_CAACATCGATAA	Doublets
Normal_CAACATGTTCCT	Plasma
Normal_CAACATTAAAAG	Plasma
Normal_CAACCAAGAAAT	Doublets
Normal_CAACGATCGTAA	HSPC
Normal_CAACGATCTATG	pDC
Normal_CAACGCAACCCA	Plasma
Normal_CAACGCAGTATA	HSPC
Normal_CAACGCTCGCTT	Plasma
Normal_CAACGGCTACGG	Doublets
Normal_CAACGGGCTTTT	Doublets
Normal_CAACGGTACTTG	cDC
Normal_CAACGTACTACC	CD4Memory
Normal_CAACTAATAGTG	Plasma
Normal_CAAGATAATTGG	Plasma
Normal_CAAGCACGATGT	CD8Memory
Normal_CAAGCAGGCGAA	Plasma
Normal_CAAGCATGGGTC	Plasma
Normal_CAAGCCCGCTTA	Doublets
Normal_CAAGGAGACTTG	Plasma
Normal_CAAGGATTTACA	HSPC
Normal_CAAGTACCGCAG	Doublets
Normal_CAAGTAGACATA	Plasma
Normal_CAAGTCATCGGG	Doublets
Normal_CAAGTCGGTAGA	Plasma
Normal_CAATACGGCATC	Doublets
Normal_CAATAGGAGTAT	Plasma
Normal_CAATCCTTCTCA	Plasma
Normal_CAATCGAGCATA	CD8Naive
Normal_CAATCGCATCCA	Plasma
Normal_CAATGACGTGAT	Plasma
Normal_CAATGACTCAGC	HSPC
Normal_CAATGGACTCGC	Plasma
Normal_CAATGGCAGGCG	Doublets
Normal_CAATTGACTGCC	Doublets
Normal_CAATTTGACCAA	Doublets
Normal_CAATTTGCATGT	HSPC
Normal_CACAACAAAATA	HSPC
Normal_CACAACCGGAAG	Plasma
Normal_CACAATAAAGAC	Plasma
Normal_CACACTCATTCG	Plasma
Normal_CACAGGTATACG	Doublets
Normal_CACATTAGAGCT	Plasma
Normal_CACCACGCTTTC	Doublets
Normal_CACCACGGTCAC	CD8TermExh
Normal_CACCGACACCTT	Doublets
Normal_CACCGAGCGTCG	Doublets
Normal_CACCGGAGCCAA	Plasma
Normal_CACCGTGCAATT	Plasma
Normal_CACCTAGGGTCC	HSPC
Normal_CACCTATTGGCC	Plasma
Normal_CACCTTGACTTG	Doublets
Normal_CACGAGACATGA	cDC
Normal_CACGCAAAAAGA	CD4Memory
Normal_CACGCGACTCAT	HSPC
Normal_CACGCGGTACTC	Doublets
Normal_CACGCTGCCCTA	HSPC
Normal_CACGGCATTCGA	cDC
Normal_CACGGGCCTCCA	Plasma
Normal_CACGTAGTCGTC	Plasma
Normal_CACGTCCCAGCC	cDC
Normal_CACGTGCCCGCT	Doublets
Normal_CACTAACCTGCA	Doublets
Normal_CACTAGTGTTGA	Doublets
Normal_CACTATACCCTC	Doublets
Normal_CACTATAGCTTC	Doublets
Normal_CACTCCGCTTCT	Plasma
Normal_CACTCTCGAGAG	Doublets
Normal_CACTGAAATCTG	Doublets
Normal_CACTGCACCCCA	Plasma
Normal_CACTGGAGGAAT	Plasma
Normal_CACTTCCCGCTT	Plasma
Normal_CAGAACATTCCT	Doublets
Normal_CAGAAGTAGTTT	cDC
Normal_CAGAATCGAGCC	Plasma
Normal_CAGACAGATTTC	Doublets
Normal_CAGACAGCCCCC	Plasma
Normal_CAGACATCAGTA	Doublets
Normal_CAGACCCTCACC	cDC
Normal_CAGACGATCGGC	CD4Memory
Normal_CAGACTTACTGA	HSPC
Normal_CAGAGCAGTGAG	HSPC
Normal_CAGAGGCGGAGC	Plasma
Normal_CAGAGGGAGATG	cDC
Normal_CAGAGTCTTAGG	Doublets
Normal_CAGATCACATAG	Plasma
Normal_CAGATGCAGGCC	HSPC
Normal_CAGATTAACTCG	CD8TermExh
Normal_CAGATTGCAATT	Plasma
Normal_CAGCAGTGCCTC	Plasma
Normal_CAGCATAGGGCT	Doublets
Normal_CAGCATATTGCA	Doublets
Normal_CAGCCAAGAGAC	Doublets
Normal_CAGCCATAATGC	Plasma
Normal_CAGCCTTAAGTC	cDC
Normal_CAGCGACATCGT	CD8Memory
Normal_CAGCGATGCGCT	cDC
Normal_CAGCTAGTTCAG	Doublets
Normal_CAGCTCCCTCGA	CD4Memory
Normal_CAGCTTCCACTA	CD8Memory
Normal_CAGCTTCTAATT	cDC
Normal_CAGGAGCTTAAC	Doublets
Normal_CAGGCCATACTA	Doublets
Normal_CAGGCTATGGAC	Plasma
Normal_CAGGCTCTTGTT	cDC
Normal_CAGGGTCTGCAG	Plasma
Normal_CAGGGTGTCTAC	Plasma
Normal_CAGGTTTTATCG	Plasma
Normal_CAGTAATGCATC	Plasma
Normal_CAGTACACCGCC	CD4Memory
Normal_CAGTACGGACTT	cDC
Normal_CAGTAGAGTCCA	Plasma
Normal_CAGTAGGCCTAT	CD8TermExh
Normal_CAGTCACGAACC	Doublets
Normal_CAGTGGAACCTC	HSPC
Normal_CAGTGTCGTCCG	HSPC
Normal_CAGTTAGTCCAT	CD4Memory
Normal_CAGTTGAAACTA	Doublets
Normal_CAGTTTTTACAT	HSPC
Normal_CATAACGTCAGT	Doublets
Normal_CATAACTCACAA	Plasma
Normal_CATAAGAACTAG	Doublets
Normal_CATAAGCCCCTA	CD8TermExh
Normal_CATAAGCGAGTT	Plasma
Normal_CATAAGTTTCAT	cDC
Normal_CATACATGGTAC	Doublets
Normal_CATACCATTCCT	CD4Memory
Normal_CATACTTCACCC	CD4Memory
Normal_CATAGACGAAAC	Plasma
Normal_CATAGCAACCAG	CD8Naive
Normal_CATAGGAGTTTC	Doublets
Normal_CATAGGCCTAGC	HSPC
Normal_CATATAAAGTAG	Plasma
Normal_CATATCACGTAT	CD4Memory
Normal_CATATCTTTAGT	Plasma
Normal_CATATGATCAAC	Plasma
Normal_CATCAAAACTAA	Plasma
Normal_CATCAGTAAACA	Doublets
Normal_CATCCACCTAAT	Doublets
Normal_CATCCATCCGTT	Doublets
Normal_CATCCCACTCAC	Plasma
Normal_CATCGAGTTTCG	Plasma
Normal_CATCGGAGTTTG	Plasma
Normal_CATCTCGGTTGA	Doublets
Normal_CATGATGATAGC	Plasma
Normal_CATGATGTCGTG	Doublets
Normal_CATGATTGCACA	Doublets
Normal_CATGCGTAAGTG	Doublets
Normal_CATGCTCCCAAG	Doublets
Normal_CATGGCGAGAAC	Plasma
Normal_CATGGGTAAATT	Doublets
Normal_CATGGTTTTAAA	Plasma
Normal_CATGTACAGCCC	Doublets
Normal_CATGTGACACGC	HSPC
Normal_CATGTTCAGTTT	HSPC
Normal_CATGTTGAAATC	Plasma
Normal_CATTAAGAGGAT	Plasma
Normal_CATTAAGAGTGT	Plasma
Normal_CATTATGAGTCG	HSPC
Normal_CATTCAAAGTAT	cDC
Normal_CATTCCTATGCA	Doublets
Normal_CATTCGAATGGA	Plasma
Normal_CATTCGATGAGG	Plasma
Normal_CATTCTGACGAG	Plasma
Normal_CATTCTTTGCCT	Plasma
Normal_CATTGAATTAGA	Plasma
Normal_CATTGACTAGGC	Doublets
Normal_CATTGCTAGATA	Plasma
Normal_CCAAACAGTTCT	HSPC
Normal_CCAAAGGCTTAT	Plasma
Normal_CCAAATAATAGG	CD4Memory
Normal_CCAACGCGTTTT	Doublets
Normal_CCAACGTACACG	Doublets
Normal_CCAAGCAAACGG	cDC
Normal_CCAAGCTAACCA	cDC
Normal_CCAAGCTACCAN	cDC
Normal_CCAAGGGTTAGT	Plasma
Normal_CCAATAACATAA	Plasma
Normal_CCAATTCTGCAT	CD8Memory
Normal_CCAATTGCTAAG	Doublets
Normal_CCACAAACCAGT	Plasma
Normal_CCACACTCACCC	HSPC
Normal_CCACCGGGTAAG	CD8TermExh
Normal_CCACCTAGTTTG	cDC
Normal_CCACCTCGCTAN	Mono
Normal_CCACCTTCGCTA	Mono
Normal_CCACTATCAATG	cDC
Normal_CCACTCATATTC	Doublets
Normal_CCACTTTCCGAA	Doublets
Normal_CCAGAGCGACAG	Doublets
Normal_CCAGATTGTCAC	Doublets
Normal_CCAGCACAGGCA	CD8Memory
Normal_CCAGCCACGAGG	Doublets
Normal_CCAGCGCTGCTC	cDC
Normal_CCAGGCATGGGA	Plasma
Normal_CCAGGCGGGCCT	CD4Memory
Normal_CCAGGGTGCGCC	Doublets
Normal_CCAGGTGGAAAC	Plasma
Normal_CCAGTAAATAAG	Plasma
Normal_CCAGTAGATGTA	HSPC
Normal_CCAGTTCCTATG	cDC
Normal_CCAGTTTCACGA	Plasma
Normal_CCATATCCGAAA	Plasma
Normal_CCATCGCCAGGG	Doublets
Normal_CCATCTTACTGT	CD4Memory
Normal_CCATGACTACGG	Doublets
Normal_CCATGGGCATGT	CD4Memory
Normal_CCATTACAAAAG	Doublets
Normal_CCATTCAGTGGG	Doublets
Normal_CCATTGCCGACC	Plasma
Normal_CCATTGGTAATT	Plasma
Normal_CCATTGGTGGAT	Plasma
Normal_CCCAAAATATCT	CD8TermExh
Normal_CCCAAATACTCC	Doublets
Normal_CCCAACACCCGT	Doublets
Normal_CCCAACTCGAGC	Doublets
Normal_CCCAACTTAAAG	Plasma
Normal_CCCAATACCAAA	Plasma
Normal_CCCAATGGGTAG	Plasma
Normal_CCCACATAGAGC	Plasma
Normal_CCCACATATGAA	cDC
Normal_CCCACGGGCTTT	HSPC
Normal_CCCACGTTAACT	Plasma
Normal_CCCACTAGCTGA	Doublets
Normal_CCCAGCCTGAGC	Doublets
Normal_CCCATAATTTCA	CD4Memory
Normal_CCCATAGTTCGC	Doublets
Normal_CCCATCGTATAA	Plasma
Normal_CCCATTAGTCTG	Plasma
Normal_CCCATTCCTTAT	Plasma
Normal_CCCCAAATCCGT	CD8Memory
Normal_CCCCACCATTTG	Doublets
Normal_CCCCATATATCT	Doublets
Normal_CCCCATTTGAGA	Doublets
Normal_CCCCCGAGCTGT	Plasma
Normal_CCCCCGTGAAAG	Doublets
Normal_CCCCGACCCGGC	HSPC
Normal_CCCCGACGGACA	Plasma
Normal_CCCCGCAGGCTT	Plasma
Normal_CCCCGTAAATAC	cDC
Normal_CCCCGTACGCGC	Plasma
Normal_CCCCTCGAATGG	Doublets
Normal_CCCCTCGTTGTA	cDC
Normal_CCCCTGCCAGTT	cDC
Normal_CCCCTTATAACC	Doublets
Normal_CCCGAAGTATGG	Doublets
Normal_CCCGACATCGAT	Doublets
Normal_CCCGACCCCTAG	Doublets
Normal_CCCGCACTTTAG	cDC
Normal_CCCGCCTCTTCC	Plasma
Normal_CCCGGATGAAAT	HSPC
Normal_CCCGGGAGCGAA	Plasma
Normal_CCCGGGCTTTGG	Doublets
Normal_CCCGGGGCACTA	Doublets
Normal_CCCGTAATTCGT	Doublets
Normal_CCCGTCTGCTTT	Plasma
Normal_CCCGTGATTCTG	HSPC
Normal_CCCGTGCGGTAT	Plasma
Normal_CCCGTTTAAAAC	Doublets
Normal_CCCGTTTCATAG	CD8Memory
Normal_CCCTAATTGGGT	Doublets
Normal_CCCTATATGGGC	cDC
Normal_CCCTATTCAGGA	Doublets
Normal_CCCTCACCTATC	Plasma
Normal_CCCTCTTAACGG	cDC
Normal_CCCTCTTAATCG	Plasma
Normal_CCCTGATAAAAG	Plasma
Normal_CCCTGTATCAAA	Doublets
Normal_CCCTGTGTTTGA	cDC
Normal_CCCTTGATTAAC	Doublets
Normal_CCCTTGCCCCTT	Doublets
Normal_CCCTTGGGTGAT	CD4Memory
Normal_CCGAACCGGTTG	Plasma
Normal_CCGACAAGTATG	Plasma
Normal_CCGACACAATGC	Doublets
Normal_CCGACGTCGCCT	CD8TermExh
Normal_CCGACTTGAGTG	Doublets
Normal_CCGAGTCCAGCT	HSPC
Normal_CCGATTACCACT	CD8Naive
Normal_CCGCAAAGTGAG	Plasma
Normal_CCGCAATGTACT	Plasma
Normal_CCGCACTTTAGN	pDC
Normal_CCGCCACCCATA	HSPC
Normal_CCGCCCGAAGGG	Doublets
Normal_CCGCCGCGTCAC	Plasma
Normal_CCGCGACACATT	Doublets
Normal_CCGCTAAAGGAT	Doublets
Normal_CCGCTCGCATAC	Plasma
Normal_CCGCTGCCATCA	Doublets
Normal_CCGCTTTCCAAT	Doublets
Normal_CCGGACCCTTTT	Doublets
Normal_CCGGACCGGTAA	Doublets
Normal_CCGGATCGAGGC	CD8TermExh
Normal_CCGGCCCCACGA	Plasma
Normal_CCGGGCAAGATG	Doublets
Normal_CCGGGCATCTAA	Doublets
Normal_CCGGGCATTGCG	Plasma
Normal_CCGGTAATCTGT	Plasma
Normal_CCGGTGTCAGGC	Doublets
Normal_CCGTAAAGATGC	Plasma
Normal_CCGTACTAGAAT	Doublets
Normal_CCGTACTCATCT	Doublets
Normal_CCGTAGCTCAAA	Plasma
Normal_CCGTAGTCGCAT	Doublets
Normal_CCGTATATGTAG	Doublets
Normal_CCGTCGAGACAG	Doublets
Normal_CCGTCGCCCAGC	Plasma
Normal_CCGTCTGACATT	Plasma
Normal_CCGTCTTACTTA	HSPC
Normal_CCGTGACAAGTC	Plasma
Normal_CCGTGACGGGTC	Plasma
Normal_CCGTGCATATGT	CD4Memory
Normal_CCGTTGCGTACT	cDC
Normal_CCGTTTTCTCGT	Doublets
Normal_CCTAAACATCGG	Plasma
Normal_CCTAAGTAATAG	CD4Memory
Normal_CCTAATTGTGTA	Doublets
Normal_CCTAGAGAAGTA	cDC
Normal_CCTAGCGGCTAG	Doublets
Normal_CCTAGTGGAAAC	CD4Memory
Normal_CCTATCTATGCT	Doublets
Normal_CCTATTTAGCGT	cDC
Normal_CCTCAACTAAGA	Plasma
Normal_CCTCAATCCACC	Doublets
Normal_CCTCAGACCACA	Doublets
Normal_CCTCGGTCAAGG	Plasma
Normal_CCTCTGAGGTCT	Doublets
Normal_CCTCTTGACCTC	CD8Memory
Normal_CCTGAAAACAGG	Doublets
Normal_CCTGAAAGTCAC	HSPC
Normal_CCTGACGGGATG	Doublets
Normal_CCTGAGAATCCG	cDC
Normal_CCTGAGGAGGGC	Plasma
Normal_CCTGAGTATGTG	Doublets
Normal_CCTGATAATTCT	Doublets
Normal_CCTGATGTAAGA	Doublets
Normal_CCTGATTGATAG	cDC
Normal_CCTGCAAACGGT	cDC
Normal_CCTGCCGCGAGA	Doublets
Normal_CCTGCTTTCCGA	HSPC
Normal_CCTGGACCCGAG	CD4Memory
Normal_CCTGGCCACACT	Plasma
Normal_CCTGTCATCGTG	cDC
Normal_CCTGTCATGTAA	Doublets
Normal_CCTGTGCGCATG	Doublets
Normal_CCTGTTAACCTT	Plasma
Normal_CCTGTTGGTATA	Plasma
Normal_CCTTAACGATTA	Doublets
Normal_CCTTACGCGAAA	CD8TermExh
Normal_CCTTAGCACCCC	Plasma
Normal_CCTTCACAAGGA	HSPC
Normal_CCTTCCCCACAG	HSPC
Normal_CCTTCGCATATC	Doublets
Normal_CCTTGAAGGTTT	Plasma
Normal_CCTTGACCAAGT	cDC
Normal_CCTTTACCGAAC	Doublets
Normal_CCTTTGAGAACT	Doublets
Normal_CCTTTGCAGCTC	Doublets
Normal_CCTTTGTCGGAG	HSPC
Normal_CGAAAAAATCCC	Plasma
Normal_CGAAACACTCTT	Doublets
Normal_CGAAACATCCTG	Plasma
Normal_CGAACAAACGGC	Doublets
Normal_CGAACGGACATG	HSPC
Normal_CGAACGGTAGGG	Doublets
Normal_CGAACTTCATGG	Plasma
Normal_CGAAGAAGGAAA	Plasma
Normal_CGAAGCCAAGGT	Plasma
Normal_CGAAGCGGTGGT	Doublets
Normal_CGAAGGGCAGCA	Plasma
Normal_CGAAGGTACTTC	Doublets
Normal_CGAAGGTCCGGT	Doublets
Normal_CGAAGTATGCTA	GammaDeltaLike
Normal_CGAAGTATTGAT	CD4Memory
Normal_CGAAGTTCTTCC	HSPC
Normal_CGAATCATCGCC	Plasma
Normal_CGACAGCACTTT	Plasma
Normal_CGACATTTACGT	HSPC
Normal_CGACCAGTGGCG	HSPC
Normal_CGACCTCGGAAC	HSPC
Normal_CGACGGTCAACC	Plasma
Normal_CGACGTAAACTG	GammaDeltaLike
Normal_CGACTTCCAGCG	cDC
Normal_CGACTTCTTCCT	Doublets
Normal_CGAGATATCGTA	cDC
Normal_CGAGCGCTCGCT	Plasma
Normal_CGAGGTGCTCGG	CD8TermExh
Normal_CGATAATTGGAG	Doublets
Normal_CGATACGGTGAT	HSPC
Normal_CGATACTTCATA	Plasma
Normal_CGATAGGAACAT	HSPC
Normal_CGATCATACACT	Doublets
Normal_CGATCGAGCTCA	Doublets
Normal_CGATGAAGGGGA	Doublets
Normal_CGATGCAGAACA	Doublets
Normal_CGATGGGCAGGA	cDC
Normal_CGATGTGGCCTG	Plasma
Normal_CGATGTGTGCGA	Doublets
Normal_CGATTCGGCAGA	CD4Memory
Normal_CGCAATTTAGAC	Plasma
Normal_CGCAGAAAAGCG	Doublets
Normal_CGCAGTCGGTCT	Doublets
Normal_CGCATACTAACA	CD8Memory
Normal_CGCATTGCTGGT	HSPC
Normal_CGCATTTCCCTA	Doublets
Normal_CGCCAAATCAAA	CD4Memory
Normal_CGCCAGCAAAAT	Plasma
Normal_CGCCAGTTCAGC	HSPC
Normal_CGCCCCAGTAAT	Doublets
Normal_CGCCCGCCCGAT	Doublets
Normal_CGCCCGGACCGG	HSPC
Normal_CGCCCGGGGCCG	HSPC
Normal_CGCCCGTAACTT	Plasma
Normal_CGCCGGCTCCTG	Doublets
Normal_CGCCGGTAGAAG	Plasma
Normal_CGCCGTATGTGA	Plasma
Normal_CGCCGTGGCCAG	cDC
Normal_CGCCTCGCCTTA	Plasma
Normal_CGCCTTTTTAAA	Plasma
Normal_CGCGATGATACT	cDC
Normal_CGCGCCTGCCCC	CD4Memory
Normal_CGCGCGGCAATA	CD4Memory
Normal_CGCGGCACATCA	CD4Memory
Normal_CGCGGTTACCGC	CD4Memory
Normal_CGCGTAGTGCCA	Doublets
Normal_CGCGTATGATAT	Doublets
Normal_CGCGTGCGGTGG	Plasma
Normal_CGCGTGGCCTGC	Plasma
Normal_CGCGTTAGGATC	Plasma
Normal_CGCTAAGCGTTC	Doublets
Normal_CGCTATCCCGCC	CD4Memory
Normal_CGCTATTTGCAG	Doublets
Normal_CGCTCTATGTGC	Plasma
Normal_CGCTGGTTGATA	Doublets
Normal_CGCTTCAGGAAC	Doublets
Normal_CGCTTTGTTATC	cDC
Normal_CGGAAGCTTGTT	Plasma
Normal_CGGAATGCACAG	Plasma
Normal_CGGAGTCCATCT	Plasma
Normal_CGGATGAGCATC	Plasma
Normal_CGGATGCTGGCC	Plasma
Normal_CGGCGCCGTCTC	cDC
Normal_CGGCGGACTGAG	Doublets
Normal_CGGCTAACAGAG	cDC
Normal_CGGCTATCCATT	Doublets
Normal_CGGCTCCCTATG	cDC
Normal_CGGGCACTGTCG	Plasma
Normal_CGGGCCGGGCGT	Plasma
Normal_CGGGCCTATCGA	Plasma
Normal_CGGGCGACCAAT	Doublets
Normal_CGGGGACCCGCA	CD4Memory
Normal_CGGGGCCACGTG	Doublets
Normal_CGGGGTTTGATA	Doublets
Normal_CGGTACCGAGAC	Doublets
Normal_CGGTAGCTCCTG	HSPC
Normal_CGGTAGTCGTCT	Plasma
Normal_CGGTCGGAAGAT	CD4Memory
Normal_CGGTCGGCCGTT	Doublets
Normal_CGGTGTCTATAG	Plasma
Normal_CGGTTGTACATC	CD4Memory
Normal_CGGTTTGCTACC	Plasma
Normal_CGTAAGGTCAAG	Doublets
Normal_CGTACCAGCTAA	Doublets
Normal_CGTACGCAACCC	Doublets
Normal_CGTACGTTACTC	Doublets
Normal_CGTAGGGAGACC	Doublets
Normal_CGTATAGTTCAG	Plasma
Normal_CGTATTTCGGAT	Doublets
Normal_CGTCACTTACAT	Doublets
Normal_CGTCAGCCGCGC	CD4Memory
Normal_CGTCAGTCAATT	Doublets
Normal_CGTCATAGACTC	NK
Normal_CGTCCGCCTTGC	Doublets
Normal_CGTCCGTACCCA	cDC
Normal_CGTCCTTTTGAG	Plasma
Normal_CGTCGCCGAGCG	Plasma
Normal_CGTCGTGAACTT	Doublets
Normal_CGTCTCATCCAT	Plasma
Normal_CGTCTTAGTACT	Plasma
Normal_CGTCTTCTACAT	Doublets
Normal_CGTCTTCTTTCA	CD4Memory
Normal_CGTGAAGGGATT	CD4Memory
Normal_CGTGAATACATG	HSPC
Normal_CGTGAGCTATGT	Doublets
Normal_CGTGAGGCACGA	Doublets
Normal_CGTGAGTCGATG	CD4Memory
Normal_CGTGCCCTGCAC	Doublets
Normal_CGTGGACACTCT	CD4Memory
Normal_CGTGGCCAATCC	Doublets
Normal_CGTGGCCATCCA	Plasma
Normal_CGTGGGTTGCAA	CD4Memory
Normal_CGTGTCAAGATA	Plasma
Normal_CGTGTGCATTCT	HSPC
Normal_CGTTAAAAGATG	Plasma
Normal_CGTTAACACCTG	Doublets
Normal_CGTTAACACTCA	Plasma
Normal_CGTTAACCTGGG	Doublets
Normal_CGTTAGAAAAGG	Plasma
Normal_CGTTAGTGGGCA	Plasma
Normal_CGTTATGACATC	Plasma
Normal_CGTTCAACACTC	CD4Memory
Normal_CGTTCCACTTGC	CD4Memory
Normal_CGTTCCAGTATG	cDC
Normal_CGTTCCATATGG	Plasma
Normal_CGTTCTCATCGG	Plasma
Normal_CGTTCTGCTTGG	Doublets
Normal_CGTTGATATCTA	cDC
Normal_CGTTGCAATCCG	Doublets
Normal_CGTTGCGGCCCT	Plasma
Normal_CGTTTAATGTAA	HSPC
Normal_CGTTTCATAAGG	Plasma
Normal_CGTTTCCGCATG	Plasma
Normal_CGTTTGCCAGGT	Doublets
Normal_CTAAAAATGCTT	Doublets
Normal_CTAAACATGTAG	CD4Memory
Normal_CTAAAGGTAAGC	CD4Memory
Normal_CTAAATGTACGT	Doublets
Normal_CTAACATACTCC	Doublets
Normal_CTAACGGAGTGA	Doublets
Normal_CTAACGGGCTCG	Doublets
Normal_CTAACGGTACTA	HSPC
Normal_CTAAGAAGAGAT	Doublets
Normal_CTAAGAAGGACG	Doublets
Normal_CTAATCCGGTCT	Doublets
Normal_CTAATCCTCTTA	Plasma
Normal_CTAATCTAAGCT	Plasma
Normal_CTAATGTACAAC	Doublets
Normal_CTAATGTCGGGC	Doublets
Normal_CTAATTCATTGC	HSPC
Normal_CTACAAAAACGC	Plasma
Normal_CTACCTAGCTGT	Doublets
Normal_CTACGCATCCCT	Doublets
Normal_CTACGGTAAGAC	Doublets
Normal_CTACTTGGCGTA	Doublets
Normal_CTAGAATGACTT	Doublets
Normal_CTAGAGGCACAT	Doublets
Normal_CTAGATACGCAT	Plasma
Normal_CTAGCAGCTAAA	Plasma
Normal_CTAGCCCGTTGA	Doublets
Normal_CTAGCGTGTGAG	Plasma
Normal_CTAGCTCTGTAG	HSPC
Normal_CTAGGGGGGGCG	CD4Memory
Normal_CTAGGTATCGGC	Plasma
Normal_CTAGTCATCCTC	Plasma
Normal_CTAGTCCTTTGT	cDC
Normal_CTAGTCGCTTAG	Plasma
Normal_CTAGTGAAAGAA	Doublets
Normal_CTATAAACCCCT	Doublets
Normal_CTATATGCCGCG	CD4Memory
Normal_CTATATTCTAGG	Plasma
Normal_CTATATTTTACT	Doublets
Normal_CTATCACTGGTG	Plasma
Normal_CTATCGTCCGGT	Plasma
Normal_CTATCTGGTGCC	Plasma
Normal_CTATCTGTTTAA	Plasma
Normal_CTATGACCGAAA	cDC
Normal_CTATGCGATCAT	Plasma
Normal_CTATGCTATTCG	Doublets
Normal_CTATGGCGTGAT	cDC
Normal_CTATGGGGAAGC	HSPC
Normal_CTATTCGGTTAT	Plasma
Normal_CTATTGCTACTA	Plasma
Normal_CTCACCAGAGTC	Plasma
Normal_CTCACGGGTAGA	cDC
Normal_CTCACGGTATGA	CD8TermExh
Normal_CTCACTTTGGAC	Doublets
Normal_CTCAGAGGAACA	CD4Memory
Normal_CTCAGTTGCTTT	Plasma
Normal_CTCATCATGGAT	Plasma
Normal_CTCATGCAGCTC	Doublets
Normal_CTCCACGACATC	cDC
Normal_CTCCAGAGATTC	Doublets
Normal_CTCCCCCCTACA	Doublets
Normal_CTCCCGACGTGT	Doublets
Normal_CTCCCTATGTCT	Plasma
Normal_CTCCCTCGAGAT	Plasma
Normal_CTCCGTAGCTTT	HSPC
Normal_CTCCGTGACCAT	Doublets
Normal_CTCCTATTTTAA	CD8TermExh
Normal_CTCCTCGTAGTG	Plasma
Normal_CTCCTCTCTCTG	HSPC
Normal_CTCCTGGGGGCC	cDC
Normal_CTCGGACAACCC	Doublets
Normal_CTCGGATGCTTG	cDC
Normal_CTCGGATTAGTC	HSPC
Normal_CTCGTCGCCCTC	Doublets
Normal_CTCGTTAGTGCT	Plasma
Normal_CTCTAAACGCAA	cDC
Normal_CTCTACAGGGAC	Doublets
Normal_CTCTACTCACCC	Doublets
Normal_CTCTAGGAGAGG	Plasma
Normal_CTCTAGGTCGAG	Plasma
Normal_CTCTGAGAAAAT	Plasma
Normal_CTCTGGACTCAA	Plasma
Normal_CTGAAATAGGGC	Plasma
Normal_CTGAACACTAGT	Plasma
Normal_CTGAATGCCACG	CD4Memory
Normal_CTGAATTACGGG	cDC
Normal_CTGACAATGCAT	Doublets
Normal_CTGACACCGTTG	HSPC
Normal_CTGACCCCAAGA	Doublets
Normal_CTGACCCGTGCT	CD4Memory
Normal_CTGAGGCCTAGC	cDC
Normal_CTGAGTGAAGCA	Plasma
Normal_CTGATAAAAAGC	Plasma
Normal_CTGATAAACAAG	Plasma
Normal_CTGATCAGAGTA	Doublets
Normal_CTGCAGACTTCA	Plasma
Normal_CTGCCAACACCC	Plasma
Normal_CTGCCACTTCAG	HSPC
Normal_CTGCCTCCTCCA	Doublets
Normal_CTGCGATTTGAC	HSPC
Normal_CTGCGGGCCCCT	HSPC
Normal_CTGCGTAGGATT	Plasma
Normal_CTGCTGGCAGAT	Plasma
Normal_CTGCTGTATTGG	Doublets
Normal_CTGCTTCACAGA	Plasma
Normal_CTGGACATTATC	Doublets
Normal_CTGGAGGGTAAT	Plasma
Normal_CTGGCCTGTCCG	Plasma
Normal_CTGGCGCGTAGG	Plasma
Normal_CTGGCGGCTCGC	Plasma
Normal_CTGGCTTTGATA	Plasma
Normal_CTGGTCTGGCTA	Plasma
Normal_CTGTACGCCGTC	Doublets
Normal_CTGTCAGAAAAG	Plasma
Normal_CTGTCGAGCTAT	Doublets
Normal_CTGTCGTTGCCT	Plasma
Normal_CTGTGCCACTCA	Plasma
Normal_CTGTGTATTACG	Doublets
Normal_CTGTTCTCGTAT	HSPC
Normal_CTGTTTCAAGGC	Doublets
Normal_CTGTTTTCTTTG	cDC
Normal_CTTAAAGTTTAA	Doublets
Normal_CTTAACGTCTGG	Doublets
Normal_CTTAAGGAGGCA	Plasma
Normal_CTTACGCATCGC	Doublets
Normal_CTTACTAGAGTA	CD4Memory
Normal_CTTAGAGTCATT	Doublets
Normal_CTTAGGAATGTG	Doublets
Normal_CTTAGGTGCCTC	Doublets
Normal_CTTATTAGATCA	Doublets
Normal_CTTCAAAGACGA	Doublets
Normal_CTTCCAGTGACT	Doublets
Normal_CTTCCAGTTTAG	CD4Memory
Normal_CTTCCGACAATG	Plasma
Normal_CTTCCGCCGATT	CD8TermExh
Normal_CTTCCGGGAGCT	Plasma
Normal_CTTCCTGAGTAT	Plasma
Normal_CTTCGCTTCCGA	Plasma
Normal_CTTCGGCTATTG	Plasma
Normal_CTTCGGGACACA	cDC
Normal_CTTCTCAGAGCA	HSPC
Normal_CTTCTCGCAGCA	Plasma
Normal_CTTCTTCCAGTG	Plasma
Normal_CTTGACGCGCCG	Doublets
Normal_CTTGAGATCATA	Plasma
Normal_CTTGATCCCGCG	Doublets
Normal_CTTGATGCTAAT	Plasma
Normal_CTTGCGTAACTT	Doublets
Normal_CTTGCGTAGGCT	cDC
Normal_CTTGCGTCTCGC	Doublets
Normal_CTTGCGTGCGAG	Doublets
Normal_CTTGCTGTACAA	Plasma
Normal_CTTGCTTACCTG	CD4Memory
Normal_CTTGGAGCCGGT	Doublets
Normal_CTTGGGCCAATT	cDC
Normal_CTTGTACTAGTG	HSPC
Normal_CTTGTTCCTCGA	CD8Naive
Normal_CTTGTTCTGCCG	Doublets
Normal_CTTTATCCGTGA	Plasma
Normal_CTTTCACGCACC	Doublets
Normal_CTTTCAGACGCT	Doublets
Normal_CTTTCATCGTAC	Plasma
Normal_CTTTCCTCGAGC	Doublets
Normal_CTTTCTTGCCAA	cDC
Normal_CTTTGAATTGAG	CD8TermExh
Normal_CTTTGACTATAC	Plasma
Normal_CTTTGAGCCGTA	Doublets
Normal_CTTTGCGAAGTG	Plasma
Normal_CTTTGGCCAGGA	Doublets
Normal_CTTTGTTTACTT	Doublets
Normal_CTTTTCAGTACC	HSPC
Normal_CTTTTCCGTTGC	Plasma
Normal_CTTTTGACCCAG	Plasma
Normal_CTTTTGTGTTAA	Doublets
Normal_CTTTTTAGAATT	Doublets
Normal_GAAACCCCCTAC	Plasma
Normal_GAAACCCTTCTC	Plasma
Normal_GAAACGTAAGAA	Doublets
Normal_GAAAGATGTGGT	Plasma
Normal_GAAAGGTGTTAA	Doublets
Normal_GAAATACCTATT	cDC
Normal_GAAATAGTGCTG	Plasma
Normal_GAAATGTCAACA	Plasma
Normal_GAAATTGGTACC	Plasma
Normal_GAACAAGAGAGT	Doublets
Normal_GAACAGGATTAA	Doublets
Normal_GAACCGGGTTGT	Doublets
Normal_GAACGAGATTCT	Plasma
Normal_GAACGTATACCG	cDC
Normal_GAACGTCACGCC	Plasma
Normal_GAACTGATCCTT	pDC
Normal_GAACTGGAACGC	Doublets
Normal_GAAGAGGGTGCA	Doublets
Normal_GAAGAGTCCCCT	Plasma
Normal_GAAGCTAGTCAC	Plasma
Normal_GAAGCTGCTGGC	Doublets
Normal_GAAGCTGTAGTA	HSPC
Normal_GAAGCTTACACA	Doublets
Normal_GAAGCTTGATTC	HSPC
Normal_GAAGGATCCATA	Doublets
Normal_GAAGGCAAGAGT	Doublets
Normal_GAAGGGCAGAAA	Plasma
Normal_GAAGTCCTACTC	HSPC
Normal_GAAGTCGACCCC	Doublets
Normal_GAAGTTTTTCCG	Plasma
Normal_GAATCTAGTTTC	Plasma
Normal_GAATGGAGCACG	Plasma
Normal_GAATTACACCCA	Plasma
Normal_GAATTCTGAGTG	Plasma
Normal_GACAAGCCAGAA	Plasma
Normal_GACAAGGAGCTG	CD4Memory
Normal_GACAATAGATTA	Plasma
Normal_GACACAATCAAC	HSPC
Normal_GACACAGTTGAG	Plasma
Normal_GACACGTTGACA	Plasma
Normal_GACAGAATAATA	Doublets
Normal_GACAGCTAGCCA	Plasma
Normal_GACAGCTCAGGG	Plasma
Normal_GACAGTCCGTCT	Doublets
Normal_GACAGTTGCTCC	Doublets
Normal_GACAGTTGTAAA	Plasma
Normal_GACATACTTGCT	Doublets
Normal_GACATCAGTCAC	Plasma
Normal_GACATGTGAGCT	CD4Memory
Normal_GACCAAACTACA	Doublets
Normal_GACCAAGAATTC	HSPC
Normal_GACCCGCAAGGG	CD4Memory
Normal_GACCCGTCAGTA	B
Normal_GACCCGTGTAGA	Doublets
Normal_GACCGCACTGAG	Doublets
Normal_GACCGGCGGGCA	Plasma
Normal_GACCGTGTACGC	Plasma
Normal_GACCTCTGAACG	Plasma
Normal_GACCTGCCGTGG	Doublets
Normal_GACGATTACGAA	CD4Memory
Normal_GACGCCACAAGT	Plasma
Normal_GACGCGAAGATA	Doublets
Normal_GACGGTTTTGAA	Doublets
Normal_GACGTCATCAAC	Plasma
Normal_GACGTGATAGAT	Doublets
Normal_GACTATATTAGC	cDC
Normal_GACTATCCCTGG	Doublets
Normal_GACTCACTACGT	Plasma
Normal_GACTCCGTTTCG	Plasma
Normal_GACTCGGCGTAC	Plasma
Normal_GACTGTTCCACG	Doublets
Normal_GACTGTTCGGGC	Plasma
Normal_GACTTTGCAAGA	Doublets
Normal_GACTTTGTTCTT	HSPC
Normal_GAGAAACCGTGA	Doublets
Normal_GAGAACGGTGAG	HSPC
Normal_GAGAAGGGGAGA	Plasma
Normal_GAGACTATTAAA	Doublets
Normal_GAGACTCTTAAT	Plasma
Normal_GAGAGACAAGAA	Doublets
Normal_GAGAGCGAGAAT	Plasma
Normal_GAGAGGCCTCCG	HSPC
Normal_GAGAGGGTGTAC	Plasma
Normal_GAGAGGTAGGCA	Plasma
Normal_GAGATCGCAATC	Doublets
Normal_GAGATGTTGCTC	Doublets
Normal_GAGCAAATGCTA	Doublets
Normal_GAGCCAAGGTCG	CD4Memory
Normal_GAGCCCACAGGC	Doublets
Normal_GAGCCCGGAAAT	Doublets
Normal_GAGCCGGTCCCC	Plasma
Normal_GAGCCGGTCGGG	Plasma
Normal_GAGCCGTTACAC	HSPC
Normal_GAGCCTACCTCA	CD4Memory
Normal_GAGCCTCTACCA	Plasma
Normal_GAGCCTTGTATG	Plasma
Normal_GAGCGAAGAGGC	HSPC
Normal_GAGCGGATCTTC	HSPC
Normal_GAGCGGTGCATG	Doublets
Normal_GAGCTTTTCGGC	Plasma
Normal_GAGGAAAATATA	Doublets
Normal_GAGGAAACTAGC	Doublets
Normal_GAGGAAGTACAT	Plasma
Normal_GAGGACCAATCA	Plasma
Normal_GAGGCGTTTCGG	Plasma
Normal_GAGGCTAGAGCA	HSPC
Normal_GAGGCTCGATCC	CD4Memory
Normal_GAGGGACACGAT	HSPC
Normal_GAGGGCAAGACN	Plasma
Normal_GAGGGGGCCTGC	Plasma
Normal_GAGGGGGCTGTA	B
Normal_GAGGTCCGGACT	Plasma
Normal_GAGGTGGAATAG	Doublets
Normal_GAGGTTATTGAC	Doublets
Normal_GAGGTTCCAGGA	Doublets
Normal_GAGGTTGGCTTG	Doublets
Normal_GAGTAACGTCGT	Doublets
Normal_GAGTAATACCGG	pDC
Normal_GAGTAGGGTGCG	Doublets
Normal_GAGTAGGTTATG	Doublets
Normal_GAGTCCTTCGGC	Doublets
Normal_GAGTCGGAACGA	Doublets
Normal_GAGTCGTCTGAG	Plasma
Normal_GAGTGATGGGGA	Doublets
Normal_GAGTTTGAACCC	Plasma
Normal_GAGTTTTAGAGA	Plasma
Normal_GAGTTTTATTTC	Doublets
Normal_GATAAACATTAC	CD4Memory
Normal_GATAACAGGCAC	Plasma
Normal_GATAACCGGTCG	Doublets
Normal_GATAATGTACCT	Plasma
Normal_GATACTCGCAGA	cDC
Normal_GATAGGGCCCGT	Doublets
Normal_GATAGTTTACTA	cDC
Normal_GATATCCACAAT	CD4Memory
Normal_GATCAAGCCTAC	Doublets
Normal_GATCATAGGTGT	Plasma
Normal_GATCCAATACCA	Doublets
Normal_GATCCCAGCCGC	cDC
Normal_GATCCCTTCTAC	Doublets
Normal_GATCCGAGTTTG	Plasma
Normal_GATCCGATAACG	Doublets
Normal_GATCGGAGGCTA	Doublets
Normal_GATCTTCATTGC	Plasma
Normal_GATCTTGGTAGA	cDC
Normal_GATGAAAGGCGG	Doublets
Normal_GATGACGGTAAG	Doublets
Normal_GATGACTACTCA	CD4Memory
Normal_GATGAGTAACTG	Plasma
Normal_GATGCACAGACA	CD8Naive
Normal_GATGCGAAGGAG	Doublets
Normal_GATGCTCCTGTG	Doublets
Normal_GATGGATCATAT	CD4Memory
Normal_GATGGCTAGAAG	Plasma
Normal_GATGGGTATGCT	Doublets
Normal_GATGTAGTGACT	Plasma
Normal_GATGTGCACACT	HSPC
Normal_GATTAAGGAAGA	Plasma
Normal_GATTCCCTGATT	Plasma
Normal_GATTCGGACCCA	Plasma
Normal_GATTCTTAGAGC	Doublets
Normal_GATTGACATACG	HSPC
Normal_GATTGCCTTTGA	Doublets
Normal_GATTGCGTGGAA	Doublets
Normal_GATTGGCTCAGG	Doublets
Normal_GATTGGGAAATC	Plasma
Normal_GATTGTGGCCTT	Plasma
Normal_GCAAAAGTTAAT	Doublets
Normal_GCAAACATTATC	Doublets
Normal_GCAACACGCTTC	cDC
Normal_GCAACGATACGC	Doublets
Normal_GCAACGCGGTTT	Plasma
Normal_GCAACTTAGTAC	Doublets
Normal_GCAAGAACTACG	Plasma
Normal_GCAAGCCTCAGA	Plasma
Normal_GCAAGCGCATAT	Plasma
Normal_GCAAGGTATTGC	Doublets
Normal_GCAAGTTTCGAT	cDC
Normal_GCAATCCCAGCG	Plasma
Normal_GCAATGATGAAG	HSPC
Normal_GCAATTGCCTGC	Plasma
Normal_GCACACACCCTC	Plasma
Normal_GCACACCGTCTA	Plasma
Normal_GCACAGCCAAGT	Plasma
Normal_GCACAGCGGGGT	Doublets
Normal_GCACAGGCACTT	Plasma
Normal_GCACAGTACAAT	Plasma
Normal_GCACATGTATGC	HSPC
Normal_GCACATTTGTCT	Doublets
Normal_GCACCAGAGTAA	cDC
Normal_GCACCCGCGGGA	HSPC
Normal_GCACCTCAAGAG	Doublets
Normal_GCACCTGAGATA	Plasma
Normal_GCACTAGTAGAA	Doublets
Normal_GCACTTCTCTAT	CD4Memory
Normal_GCAGCGGGTGAG	HSPC
Normal_GCAGGCACCCGG	Doublets
Normal_GCAGGGCGGATT	Doublets
Normal_GCAGTGGGAACG	Plasma
Normal_GCATCACACTCT	Doublets
Normal_GCATCCACCGTA	CD4Memory
Normal_GCATCGAAGCTA	Plasma
Normal_GCATCTAATTGG	HSPC
Normal_GCATGGTTATCA	CD8Memory
Normal_GCATGTGGGGAG	Doublets
Normal_GCATTCGGGTCT	Doublets
Normal_GCCAAAGTAATG	Plasma
Normal_GCCACAGTGGTG	Doublets
Normal_GCCACATCGGAT	Doublets
Normal_GCCACCAGCGGT	Doublets
Normal_GCCACTATAACA	Plasma
Normal_GCCAGCAAAGGC	Doublets
Normal_GCCAGGCATACG	Doublets
Normal_GCCATCAGTGAA	Doublets
Normal_GCCATCCTTGTA	Plasma
Normal_GCCATCTCATAA	Doublets
Normal_GCCATTATATCT	Plasma
Normal_GCCCAAAGGCTA	Doublets
Normal_GCCCACAGCGAG	CD4Memory
Normal_GCCCGCGCCACT	Doublets
Normal_GCCCGTACAGTC	Doublets
Normal_GCCCTAGTCGAT	cDC
Normal_GCCGAAAGCAGC	Doublets
Normal_GCCGAAGACGCC	Doublets
Normal_GCCGATTCATCC	Doublets
Normal_GCCGCCTCACCG	Doublets
Normal_GCCGCTACTGAG	Doublets
Normal_GCCGCTAGGCTC	CD4Memory
Normal_GCCGGATCTAGA	cDC
Normal_GCCGGCTCAAGA	Doublets
Normal_GCCGGTGCGTGA	cDC
Normal_GCCGTCACAATG	CD4Memory
Normal_GCCGTCCGCTGA	Doublets
Normal_GCCTAAGTTGGC	Doublets
Normal_GCCTAGACAAAC	Plasma
Normal_GCCTGCCTCTTA	cDC
Normal_GCCTTATGACCC	cDC
Normal_GCGAAGGGGATC	cDC
Normal_GCGACGGATATC	Plasma
Normal_GCGACTCGGTGA	cDC
Normal_GCGACTTTTCCC	Doublets
Normal_GCGAGAGCCATC	Plasma
Normal_GCGAGATCTCGG	Plasma
Normal_GCGATGTAAAAG	Plasma
Normal_GCGATGTCCTAA	Plasma
Normal_GCGATGTGGCTC	CD4Memory
Normal_GCGATTTGAAAG	Plasma
Normal_GCGCAACACATA	Doublets
Normal_GCGCATATTATG	Plasma
Normal_GCGCATTGATCC	Doublets
Normal_GCGCCACTACAC	Doublets
Normal_GCGCGGCTACGG	CD4Memory
Normal_GCGCGGGGAAGT	Plasma
Normal_GCGCGGGTATAG	CD4Memory
Normal_GCGCGGGTGGTA	Plasma
Normal_GCGCTACAAGAT	Doublets
Normal_GCGCTCGCCTCA	Doublets
Normal_GCGCTTGGGCCC	cDC
Normal_GCGGAATAGTGT	cDC
Normal_GCGGAGTCGGTT	Doublets
Normal_GCGGCTGCTGTT	Plasma
Normal_GCGGGCAACTTA	HSPC
Normal_GCGGGCGATGAC	Doublets
Normal_GCGGGCTATACC	Doublets
Normal_GCGGGGTGAAGA	HSPC
Normal_GCGGGTCCATAG	Plasma
Normal_GCGGGTGTCTCA	cDC
Normal_GCGGTGCCGTGC	Doublets
Normal_GCGTAACTACTA	Plasma
Normal_GCGTAGCGCGTG	Plasma
Normal_GCGTATTACGAN	B
Normal_GCGTATTAGCGA	cDC
Normal_GCGTCCGCGCCG	CD4Memory
Normal_GCGTCGAGCAGT	Plasma
Normal_GCGTGACGAGCC	Plasma
Normal_GCGTGCAACGAT	Plasma
Normal_GCGTGCGCACGC	Plasma
Normal_GCGTGGGTCACA	Plasma
Normal_GCTAACTTAAGT	HSPC
Normal_GCTACAAGACCG	cDC
Normal_GCTACACCAATA	Plasma
Normal_GCTACCGCACCC	Plasma
Normal_GCTAGAACGTAT	Doublets
Normal_GCTAGAAGATAG	HSPC
Normal_GCTAGCATCGAC	cDC
Normal_GCTAGGCTATCG	Doublets
Normal_GCTATTCTAATT	Doublets
Normal_GCTCAAAGCTCT	Doublets
Normal_GCTCAATAACTT	HSPC
Normal_GCTCCACCGTAC	Plasma
Normal_GCTCCCATATGA	Plasma
Normal_GCTCCGACTTAA	ProB
Normal_GCTCCGGGCCGC	cDC
Normal_GCTCGCCCTTCA	Doublets
Normal_GCTCGGACTCGA	Plasma
Normal_GCTCTATCACTG	Doublets
Normal_GCTCTCCCATTA	cDC
Normal_GCTCTTATCATG	Doublets
Normal_GCTCTTCAGGCC	HSPC
Normal_GCTGACAGTCTA	Doublets
Normal_GCTGAGCCGAAA	Plasma
Normal_GCTGAGCTCCGG	Doublets
Normal_GCTGAGGAGATC	Doublets
Normal_GCTGAGTATTAA	cDC
Normal_GCTGATGGAAAG	CD8Naive
Normal_GCTGCTATTAGA	Plasma
Normal_GCTGGGGGTTGA	Doublets
Normal_GCTGGTTGGACC	HSPC
Normal_GCTGTACATGTT	Doublets
Normal_GCTGTCGAATAG	Doublets
Normal_GCTGTGGTTGTC	CD4Memory
Normal_GCTGTTAGCGAT	Doublets
Normal_GCTTATATTGCA	Plasma
Normal_GCTTCGCTACAA	cDC
Normal_GCTTCGGCTCTA	Doublets
Normal_GCTTCGTACATT	Doublets
Normal_GCTTGCATACGC	Doublets
Normal_GCTTGGTGCCGC	HSPC
Normal_GCTTGTGGACGG	CD8Memory
Normal_GCTTGTGGTCAG	HSPC
Normal_GCTTTAGGATCG	Doublets
Normal_GCTTTAGGCCCC	Plasma
Normal_GCTTTCTCCCTC	Plasma
Normal_GCTTTGCAGGGT	cDC
Normal_GGAAAGCCTTGC	Doublets
Normal_GGAAAGTACTAG	CD4Memory
Normal_GGAAAGTGTGCG	Doublets
Normal_GGAACCAGTTAA	cDC
Normal_GGAACCGAGTAG	cDC
Normal_GGAAGACCGAAG	Plasma
Normal_GGAATAAATTTA	Doublets
Normal_GGAATAATTATA	Plasma
Normal_GGAATATTTCGT	CD8TermExh
Normal_GGAATCAAGGGA	CD4Memory
Normal_GGAATGAGTTCC	Plasma
Normal_GGAATGCCGACT	Doublets
Normal_GGAATTCCTGGT	Plasma
Normal_GGAATTCGTTTT	Doublets
Normal_GGACAATCGCCT	Plasma
Normal_GGACAATGATAT	CD4Memory
Normal_GGACACAAGTTC	Plasma
Normal_GGACAGTCTACG	Doublets
Normal_GGACATCACCTA	Plasma
Normal_GGACCGCTTCCG	Plasma
Normal_GGACCGTCGCTC	Plasma
Normal_GGACCTTGCACC	CD4Memory
Normal_GGACGCCTTGCG	Doublets
Normal_GGACTAAGGGAA	Plasma
Normal_GGACTAGGTTAA	Plasma
Normal_GGACTCGAAGTC	Plasma
Normal_GGACTGCCGTTT	Doublets
Normal_GGACTGTCAAAT	CD4Memory
Normal_GGAGAAGATCGT	Doublets
Normal_GGAGAATGTTAT	Doublets
Normal_GGAGACCGAGAT	Plasma
Normal_GGAGCTGGCTGA	Doublets
Normal_GGAGGGCGCTCT	Doublets
Normal_GGAGGTCGTTAT	cDC
Normal_GGAGGTGTCAGA	Plasma
Normal_GGAGGTTGCACG	Doublets
Normal_GGAGTAAATTAT	Doublets
Normal_GGAGTCAGCGGA	cDC
Normal_GGAGTGCGATAA	Mono
Normal_GGAGTTGGAATG	Doublets
Normal_GGAGTTTCGAAC	CD8TermExh
Normal_GGATAGCTTTCG	cDC
Normal_GGATAGGGTACA	Plasma
Normal_GGATCCTCCTAA	Plasma
Normal_GGATCGTAAACA	Plasma
Normal_GGATCGTCATAA	Plasma
Normal_GGATGACACGGC	Doublets
Normal_GGATGGGGGGGA	cDC
Normal_GGATGTATAAGC	Doublets
Normal_GGATTACTGCAC	Doublets
Normal_GGATTTATGGGC	Doublets
Normal_GGATTTGGTATA	Doublets
Normal_GGCAACAGAGGT	Doublets
Normal_GGCAATGAAGTT	B
Normal_GGCAGATTTGCG	Plasma
Normal_GGCAGCGCTTCC	Plasma
Normal_GGCAGGACTAAC	Doublets
Normal_GGCAGGCATTAG	Plasma
Normal_GGCAGGGGCGTC	Plasma
Normal_GGCAGTAATTAG	Doublets
Normal_GGCAGTGCACAA	cDC
Normal_GGCATACCTACA	Doublets
Normal_GGCATAGGTAAG	Plasma
Normal_GGCATGGGGACC	cDC
Normal_GGCCACATACGT	Plasma
Normal_GGCCACTGGTAT	Doublets
Normal_GGCCACTTACCT	Plasma
Normal_GGCCCAATCACT	Doublets
Normal_GGCCCGACAGGA	HSPC
Normal_GGCCGAGTAGTC	Doublets
Normal_GGCCGCGGCGGT	Doublets
Normal_GGCCGGGTGGAG	Doublets
Normal_GGCCTCCATCGA	Doublets
Normal_GGCCTCGATTCT	Plasma
Normal_GGCCTGAAAGCA	Doublets
Normal_GGCGAAGATCCT	Plasma
Normal_GGCGACCTCTGG	Plasma
Normal_GGCGCGTTAACC	Plasma
Normal_GGCGCTGGAACC	Plasma
Normal_GGCGGAGACACT	HSPC
Normal_GGCGGCCATTGC	cDC
Normal_GGCGGCGGAGCC	CD4Memory
Normal_GGCGGGAGGCTG	Plasma
Normal_GGCGTATACACA	Doublets
Normal_GGCGTCGTTGCC	Doublets
Normal_GGCGTGAATACA	Plasma
Normal_GGCGTTAGCCCC	cDC
Normal_GGCGTTATACCA	Doublets
Normal_GGCGTTTACCTA	Plasma
Normal_GGCTAACAGTTA	CD4Memory
Normal_GGCTAATGTGAG	Doublets
Normal_GGCTACTGCCCT	Plasma
Normal_GGCTAGGGTTAT	cDC
Normal_GGCTCATTTACA	Plasma
Normal_GGCTCCTGAGAG	cDC
Normal_GGCTCTAGAGGA	Doublets
Normal_GGCTGACAAACT	Plasma
Normal_GGCTGAGCCCCG	Doublets
Normal_GGCTGATGAACG	Doublets
Normal_GGCTGGTGAGGT	CD8Memory
Normal_GGCTTTGCCCGC	Plasma
Normal_GGGAACGCGCGT	Plasma
Normal_GGGAATGGGGGC	Doublets
Normal_GGGACACGGATC	Doublets
Normal_GGGACATCGGGC	CD8Memory
Normal_GGGACGAGCACA	CD4Memory
Normal_GGGACGGTTCTT	Doublets
Normal_GGGAGATCTACG	Plasma
Normal_GGGAGCAGATCA	Doublets
Normal_GGGAGGGGAAGG	CD4Memory
Normal_GGGATAAGTACA	Plasma
Normal_GGGATTATAGGT	Doublets
Normal_GGGATTTGTTGT	Doublets
Normal_GGGCAGGTTAAC	Doublets
Normal_GGGCCCAGATCG	Plasma
Normal_GGGCCGGATATA	Plasma
Normal_GGGCCTACATAG	Plasma
Normal_GGGCGGCTGTCA	B
Normal_GGGCTCCTTGGA	Plasma
Normal_GGGCTTCGCGGC	Plasma
Normal_GGGGAACATTAT	CD4Memory
Normal_GGGGATGACCTC	cDC
Normal_GGGGATTCCAAC	Doublets
Normal_GGGGCGGCCGGG	cDC
Normal_GGGGCGGGTTCA	Plasma
Normal_GGGGCGTACTAA	HSPC
Normal_GGGGGGAGTGCT	Doublets
Normal_GGGGGTTACACT	HSPC
Normal_GGGGGTTTCCAT	pDC
Normal_GGGGTGCCTTGA	Doublets
Normal_GGGGTGTGCCAT	CD4Memory
Normal_GGGGTTGTACTT	Doublets
Normal_GGGTACCCGAGA	Doublets
Normal_GGGTAGCCGGAA	HSPC
Normal_GGGTATCGGCAT	Doublets
Normal_GGGTCTGGGCAC	Plasma
Normal_GGGTCTTGGACA	Doublets
Normal_GGGTTAATGATG	pDC
Normal_GGTAACCTAGTC	Doublets
Normal_GGTAAGGTGTGT	HSPC
Normal_GGTAAGGTTTTC	Doublets
Normal_GGTAATCAGGTC	Doublets
Normal_GGTAATCATTGA	cDC
Normal_GGTACCTCCCGT	Plasma
Normal_GGTAGATGCCTC	Doublets
Normal_GGTAGCATCCTA	HSPC
Normal_GGTAGCATGGCT	HSPC
Normal_GGTAGGCGTGAA	HSPC
Normal_GGTAGGGCACGG	Plasma
Normal_GGTAGTACAGGC	Plasma
Normal_GGTATAGATTGC	Doublets
Normal_GGTATTAACAAC	Plasma
Normal_GGTCAATTGTCA	CD8TermExh
Normal_GGTCACCAACTC	CD8Memory
Normal_GGTCACCGGAGT	Plasma
Normal_GGTCATCCAGGG	Doublets
Normal_GGTCCAGGAGTG	Doublets
Normal_GGTCCGCATTCA	Doublets
Normal_GGTCCGGGGCCC	Plasma
Normal_GGTCGACTGACA	Doublets
Normal_GGTCGAGAAGGT	Plasma
Normal_GGTCGCTCTCAC	CD4Memory
Normal_GGTCGTACTCCA	pDC
Normal_GGTCTAACCCCC	Doublets
Normal_GGTCTACAATTC	CD4Memory
Normal_GGTCTCTCTAGG	Doublets
Normal_GGTCTGTTATCT	GammaDeltaLike
Normal_GGTGAAGACAGG	ProB
Normal_GGTGAATCAATG	Plasma
Normal_GGTGACACTGAG	CD4Memory
Normal_GGTGACCTCACT	Plasma
Normal_GGTGATATCCGC	Doublets
Normal_GGTGCCCATACA	Doublets
Normal_GGTGCGGTTATC	HSPC
Normal_GGTGGAACCGTG	Plasma
Normal_GGTGGAGCTCTG	Doublets
Normal_GGTGGGCACAAA	Plasma
Normal_GGTGTGTCTGCA	CD4Memory
Normal_GGTGTGTTGGCG	Plasma
Normal_GGTGTTACTTGC	Doublets
Normal_GGTTAACTGTAT	CD4Memory
Normal_GGTTAATACGTA	Plasma
Normal_GGTTACAACCAT	Doublets
Normal_GGTTACGCAGAC	Plasma
Normal_GGTTATAGCACG	CD8TermExh
Normal_GGTTATGAAGCC	CD4Memory
Normal_GGTTATGATCGG	Doublets
Normal_GGTTCAAACTTA	Doublets
Normal_GGTTCACTGTGG	Doublets
Normal_GGTTCCAATCTT	Plasma
Normal_GGTTCCCAGGTC	Doublets
Normal_GGTTCCTAACGG	cDC
Normal_GGTTCCTTCTCG	cDC
Normal_GGTTCTCAAGTA	Doublets
Normal_GGTTGGATATCC	Doublets
Normal_GGTTGGCTCACC	CD4Memory
Normal_GGTTTAAGACAC	HSPC
Normal_GGTTTCTACTCC	Plasma
Normal_GGTTTGTTCGGT	HSPC
Normal_GTAAAATTGGAG	Plasma
Normal_GTAACTAAACCC	Doublets
Normal_GTAACTCCAAGA	Doublets
Normal_GTAAGATGTGAG	CD4Memory
Normal_GTAAGCTCAGCG	Doublets
Normal_GTAAGGATCAAC	Plasma
Normal_GTAAGGTTCTTA	Doublets
Normal_GTAAGTCGGAAT	Plasma
Normal_GTAAGTGGGCTT	Doublets
Normal_GTAATAAATTCT	Plasma
Normal_GTAATATCGTTC	Plasma
Normal_GTAATGACGGTC	HSPC
Normal_GTAATGAGACCG	cDC
Normal_GTAATTTCGCCT	Plasma
Normal_GTACATTTAGGA	Plasma
Normal_GTACCGTTACAA	Plasma
Normal_GTACCTTGGAAC	HSPC
Normal_GTACGGATACCA	Doublets
Normal_GTACGTTCTAGC	Doublets
Normal_GTACTTCCCAGG	Plasma
Normal_GTACTTTAGCGG	HSPC
Normal_GTAGCAGCCGGC	cDC
Normal_GTAGCGACCCTA	Doublets
Normal_GTAGCTCACTTG	CD4Memory
Normal_GTAGGCCTTCAG	Doublets
Normal_GTAGGTGGCTAA	Doublets
Normal_GTAGGTTAATCC	Doublets
Normal_GTAGTAATCCAG	Doublets
Normal_GTAGTACGCGAC	CD8Memory
Normal_GTAGTACTCTGG	cDC
Normal_GTAGTCAGTCGC	cDC
Normal_GTAGTTGTTCTA	Doublets
Normal_GTAGTTTTCTGT	Doublets
Normal_GTATAAGAGATT	Doublets
Normal_GTATACGCCAGC	CD4Memory
Normal_GTATACGTAGAC	CD4Memory
Normal_GTATAGTAGGAT	Doublets
Normal_GTATCAACAAAA	Doublets
Normal_GTATCAGACTGN	Doublets
Normal_GTATCCTCGGAT	Plasma
Normal_GTATGCCACGTC	Doublets
Normal_GTATTGCCGCCC	Plasma
Normal_GTCAATAAGTGT	Plasma
Normal_GTCACCCCGTCA	Plasma
Normal_GTCAGCCAGTAG	Mono
Normal_GTCAGGAAGGCC	CD8TermExh
Normal_GTCAGGGTAGTG	Plasma
Normal_GTCAGTCCGGCC	CD4Memory
Normal_GTCATCGCTTTT	HSPC
Normal_GTCATCTGAGGA	cDC
Normal_GTCATGGAATTC	Plasma
Normal_GTCATTTTATCC	Plasma
Normal_GTCCACAGTTCG	Doublets
Normal_GTCCCACCCCGG	Doublets
Normal_GTCCCCGATCCG	Plasma
Normal_GTCCCGGCTCAT	Plasma
Normal_GTCCGTACGATC	Doublets
Normal_GTCCGTAGTGCC	Plasma
Normal_GTCCTGACCAAC	Plasma
Normal_GTCCTGTAGACA	Plasma
Normal_GTCCTTGCTCCT	CD4Memory
Normal_GTCGATGGATTC	Plasma
Normal_GTCGCAACAATG	cDC
Normal_GTCGCGAGGGTT	Doublets
Normal_GTCGCTCATAGT	Plasma
Normal_GTCGGAGTGTTC	HSPC
Normal_GTCGGGACACGA	Doublets
Normal_GTCGGGATGCGG	Doublets
Normal_GTCGTCCAATAC	pDC
Normal_GTCTAGGTCTTT	Plasma
Normal_GTCTATTAAGCA	Plasma
Normal_GTCTCAAGAGAT	Doublets
Normal_GTCTCGAGCCAG	Doublets
Normal_GTCTGTGTATGC	CD8TermExh
Normal_GTCTTCTCACGT	Plasma
Normal_GTCTTTTATTAC	Doublets
Normal_GTGAACATTGAG	HSPC
Normal_GTGAAGATACGA	Plasma
Normal_GTGAAGGAGAGC	Plasma
Normal_GTGAAGTGCGAG	Plasma
Normal_GTGACCAAGGTC	HSPC
Normal_GTGACTGGTCTT	Plasma
Normal_GTGAGAATTAAC	HSPC
Normal_GTGAGCCCCCCC	Plasma
Normal_GTGAGTAGAAAC	cDC
Normal_GTGAGTGATCAT	Doublets
Normal_GTGCAAGCGTGC	CD4Memory
Normal_GTGCACGAATAT	Plasma
Normal_GTGCAGAAAGTG	Plasma
Normal_GTGCGTAACAAG	Doublets
Normal_GTGCTAGCTCCC	CD4Memory
Normal_GTGGATTCGGGT	CD4Memory
Normal_GTGGCACATTGG	Plasma
Normal_GTGGCAGCCCTC	CD4Memory
Normal_GTGGCCCCCGCT	Doublets
Normal_GTGGCCGGGTAG	Plasma
Normal_GTGGCGTATGCA	HSPC
Normal_GTGGCTATTGAA	HSPC
Normal_GTGGCTGGTAAG	Doublets
Normal_GTGGGTCCAGAG	HSPC
Normal_GTGGTGTCCACG	Plasma
Normal_GTGGTTATTGTT	Doublets
Normal_GTGTAACAAACT	CD4Memory
Normal_GTGTCCATCTCA	Doublets
Normal_GTGTCCCATTGT	Plasma
Normal_GTGTCGGAAAGG	HSPC
Normal_GTGTCGGAAGTG	CD4Memory
Normal_GTGTCGGGGCCT	CD4Memory
Normal_GTGTCTATAAGG	Doublets
Normal_GTGTGACGCTTC	Doublets
Normal_GTGTGGTAATCA	CD4Memory
Normal_GTGTGTCCTAGA	Plasma
Normal_GTGTGTTGTACA	Plasma
Normal_GTGTTACAATGA	Plasma
Normal_GTGTTTATATTG	Plasma
Normal_GTGTTTTCAGCC	Plasma
Normal_GTTAACATGCAC	Doublets
Normal_GTTACACCTCGG	Doublets
Normal_GTTACAGCTGAG	Doublets
Normal_GTTACGCTTGGT	Doublets
Normal_GTTATATACCAG	HSPC
Normal_GTTATCCACTAT	HSPC
Normal_GTTATCGCGGTG	cDC
Normal_GTTCAAAGGACC	Plasma
Normal_GTTCAAATCTAA	Plasma
Normal_GTTCACGAATTC	Plasma
Normal_GTTCGTAGAGGC	Plasma
Normal_GTTCGTTCTTAT	Doublets
Normal_GTTCTTGCCTGT	Plasma
Normal_GTTGAACGGGAA	Doublets
Normal_GTTGGAATAAGG	Plasma
Normal_GTTGGGCAACAG	Plasma
Normal_GTTGTCCCCAAC	Plasma
Normal_GTTTACAGCTCC	Plasma
Normal_GTTTACCTTCCG	CD4Memory
Normal_GTTTAGCCCCTC	Doublets
Normal_GTTTATGCTCAA	CD4Memory
Normal_GTTTCACTAGTG	Doublets
Normal_GTTTCATCTCAT	CD4Memory
Normal_GTTTCATTGACG	Doublets
Normal_GTTTCCTGTTTT	Plasma
Normal_GTTTCTTATAGA	Plasma
Normal_GTTTGAAGTGCG	Plasma
Normal_GTTTGACCGATG	cDC
Normal_GTTTGGAATCAA	Plasma
Normal_GTTTGTAGAAAC	Plasma
Normal_GTTTGTTATCTA	CD4Memory
Normal_GTTTTCTAACGG	Plasma
Normal_TAAAAAAGGTTA	cDC
Normal_TAAAACAGCTTG	cDC
Normal_TAAAAGGGAGGC	Doublets
Normal_TAAAATAGCACG	Plasma
Normal_TAAAGACTCTAA	Plasma
Normal_TAAAGATGAGAT	Doublets
Normal_TAAAGTCCTTGA	CD4Memory
Normal_TAAATAAAACCA	Plasma
Normal_TAAATATTCGAT	Doublets
Normal_TAAATCGAGTTT	Doublets
Normal_TAAATGGTCAGA	Doublets
Normal_TAAATGTGTCGA	Doublets
Normal_TAACAAGGCGTA	Plasma
Normal_TAACACATGGAG	Plasma
Normal_TAACATCGCAAC	Doublets
Normal_TAACCGGTAGTG	Plasma
Normal_TAACCTATAGAC	cDC
Normal_TAACGACTAATC	Doublets
Normal_TAACGGCAAATA	CD4Memory
Normal_TAACGGCTGCTC	Doublets
Normal_TAACGGGCCCGT	cDC
Normal_TAACGTCATGTC	Doublets
Normal_TAACGTGCCTCG	Plasma
Normal_TAAGATGTCCGC	Plasma
Normal_TAAGCCCGTACT	Doublets
Normal_TAAGCGGTCTCA	pDC
Normal_TAAGCGTATTAC	Plasma
Normal_TAAGCTCCGGGG	CD4Memory
Normal_TAAGGATAAGTA	Plasma
Normal_TAAGGGACCCCA	pDC
Normal_TAAGTCCCTCTT	HSPC
Normal_TAAGTCTAACTC	Plasma
Normal_TAAGTGTGGGAT	Doublets
Normal_TAAGTTCCGTAA	CD4Memory
Normal_TAATATGGCCCT	Plasma
Normal_TAATCAATACTC	CD4Memory
Normal_TAATCGCGTAGA	Plasma
Normal_TAATCGGGTCCG	cDC
Normal_TAATGTCGATGG	HSPC
Normal_TAATTAGGCTAC	Doublets
Normal_TAATTCATGAAT	Doublets
Normal_TAATTCGGGACC	Doublets
Normal_TACAAGTCCGTA	Doublets
Normal_TACACAATTTCA	Plasma
Normal_TACAGAGCCCGC	HSPC
Normal_TACCAAAACGGG	Doublets
Normal_TACCACCCTTGC	Plasma
Normal_TACCACCGCTTT	HSPC
Normal_TACCAGATCTCG	HSPC
Normal_TACCATCCCTAC	Doublets
Normal_TACCATGCGGCT	HSPC
Normal_TACCCCAGGAGA	CD8Memory
Normal_TACCCGAACTGA	CD8TermExh
Normal_TACCCGCACTTG	Plasma
Normal_TACCGATCAGGA	Plasma
Normal_TACCGGAACGAT	Doublets
Normal_TACCTCTATAGT	HSPC
Normal_TACCTTCGTGTC	cDC
Normal_TACCTTGCGGGC	cDC
Normal_TACGAGAGTCCT	Plasma
Normal_TACGAGCAAGTA	Doublets
Normal_TACGCCTTTACG	Doublets
Normal_TACGCTGACGAT	cDC
Normal_TACGGACGCCTA	Plasma
Normal_TACGGATAAGAT	CD4Memory
Normal_TACGGCATGTCG	Plasma
Normal_TACGGCGGGTTT	cDC
Normal_TACGGGCATATA	Plasma
Normal_TACGGGGAGCCC	Doublets
Normal_TACGGGTGGTGC	Plasma
Normal_TACGGTAATAGG	Plasma
Normal_TACGGTATGTAC	Plasma
Normal_TACTAATCGTCT	Doublets
Normal_TACTACATTCCG	cDC
Normal_TACTCATAGTGG	Doublets
Normal_TACTCTGATCGA	Plasma
Normal_TACTGCTACAGG	Doublets
Normal_TACTGCTAGCCT	Doublets
Normal_TACTGGTGGGAT	Plasma
Normal_TAGAAGCATGTT	Plasma
Normal_TAGAAGGCGACC	cDC
Normal_TAGAATACACCC	Doublets
Normal_TAGACAAGCCTG	Plasma
Normal_TAGACAATGCTA	Plasma
Normal_TAGACGGCTTAT	CD4Memory
Normal_TAGACGGTGGAT	HSPC
Normal_TAGACTTTCTTA	Doublets
Normal_TAGATAAGGCGG	Plasma
Normal_TAGATACGTTCA	HSPC
Normal_TAGATATTCTGG	Doublets
Normal_TAGATATTGCTA	CD4Memory
Normal_TAGATGATGGCA	NK
Normal_TAGCAGGTCTGT	CD4Memory
Normal_TAGCATGGTACC	Doublets
Normal_TAGCCACAGTAT	HSPC
Normal_TAGCCGCTAGGG	Plasma
Normal_TAGCCTCATATA	Doublets
Normal_TAGCCTGTGATT	HSPC
Normal_TAGCGAACGCAT	Doublets
Normal_TAGCTACAAAGC	CD4Memory
Normal_TAGCTTTCTCTC	HSPC
Normal_TAGCTTTTAACG	Doublets
Normal_TAGGCCTTGTAG	CD4Memory
Normal_TAGGCTACTGGT	Doublets
Normal_TAGGGATCTAGT	Plasma
Normal_TAGGGCGTGTAA	Plasma
Normal_TAGTATTTGCTT	Plasma
Normal_TAGTCAACAAAT	Plasma
Normal_TAGTCGGGAAGG	HSPC
Normal_TAGTCTCCGTCC	Plasma
Normal_TAGTCTGCCAGC	Doublets
Normal_TAGTGCATGCGG	Doublets
Normal_TAGTGTTATCCC	CD4Memory
Normal_TAGTGTTGACTC	Plasma
Normal_TAGTTCTGCCCA	CD4Memory
Normal_TATAATTAAAGT	Plasma
Normal_TATACAATGTGG	Doublets
Normal_TATACTGCCTTG	Plasma
Normal_TATACTGCGTAT	Doublets
Normal_TATACTTTTCTC	Plasma
Normal_TATAGACCGGGC	Doublets
Normal_TATAGAGGTAAG	Doublets
Normal_TATATGTCCCAA	Plasma
Normal_TATATGTGTCAT	Doublets
Normal_TATCAGGAAGGA	Doublets
Normal_TATCCCGAACGT	Doublets
Normal_TATCCCGGACTC	Doublets
Normal_TATCCCGGCTAC	Plasma
Normal_TATCGAAAGGCC	Plasma
Normal_TATCGCAAGTGG	HSPC
Normal_TATCTACCTTTA	Doublets
Normal_TATGAATCCTCA	Plasma
Normal_TATGACAGTTCT	cDC
Normal_TATGGTCCTAAG	Plasma
Normal_TATGGTGCCCAA	CD8TermExh
Normal_TATGTAATGCGA	CD8Naive
Normal_TATGTGAGAAGT	cDC
Normal_TATTAAGTCGAT	Doublets
Normal_TATTATCAACTA	CD4Memory
Normal_TATTCAAGACAT	Plasma
Normal_TATTCCCTGCTT	Plasma
Normal_TATTCTCGATAC	Plasma
Normal_TATTCTTAACTT	cDC
Normal_TATTGCTCCTTC	Doublets
Normal_TATTGTCATACG	Doublets
Normal_TATTTACCCACC	CD8TermExh
Normal_TATTTACGTATT	Plasma
Normal_TATTTCTAGAAT	Doublets
Normal_TATTTTCCATTT	HSPC
Normal_TATTTTGCAGTC	CD8TermExh
Normal_TATTTTTCAGTT	cDC
Normal_TCAAAACCAGTT	Doublets
Normal_TCAAAAGCCGTT	HSPC
Normal_TCAAACTGTCCC	Plasma
Normal_TCAAAGGGAGCC	Doublets
Normal_TCAAATTGCCTG	CD8Naive
Normal_TCAACCGAGAGG	Plasma
Normal_TCAACGGCGATC	CD4Memory
Normal_TCAACTCCCTGC	Plasma
Normal_TCAAGCTTGAGT	Plasma
Normal_TCAATAAGGCTT	Plasma
Normal_TCAATTAAGCTG	HSPC
Normal_TCACAGCTTGGA	Doublets
Normal_TCACCAGGATCT	Plasma
Normal_TCACCGGATTAA	pDC
Normal_TCACGAACTGTG	Doublets
Normal_TCACGACAGACC	Plasma
Normal_TCACGTCTTGTT	Plasma
Normal_TCACTAAGGCGT	Plasma
Normal_TCACTACATATT	CD4Memory
Normal_TCACTGCCATTC	cDC
Normal_TCACTTGGGGGC	Doublets
Normal_TCAGATATATAA	Doublets
Normal_TCAGCGATCGAC	Plasma
Normal_TCAGCGCAACCA	Doublets
Normal_TCAGCTACTTAG	Doublets
Normal_TCAGGTACGTCG	Doublets
Normal_TCAGGTTCAGAG	Plasma
Normal_TCAGTGGCGACT	Doublets
Normal_TCATCTTACGTT	Plasma
Normal_TCATCTTGAAGT	Doublets
Normal_TCATTCCATGAC	Plasma
Normal_TCCAAATTGCAG	Plasma
Normal_TCCAACCCAACC	CD4Memory
Normal_TCCAAGCAAACG	Doublets
Normal_TCCACACTTCGT	CD8Memory
Normal_TCCACGTAACTA	Plasma
Normal_TCCACTGGCGAT	Doublets
Normal_TCCACTTTATCT	Doublets
Normal_TCCAGAAGAAGG	Plasma
Normal_TCCAGGACTTCT	Plasma
Normal_TCCAGGCCCTAG	Doublets
Normal_TCCAGGGTGGTA	HSPC
Normal_TCCAGTCAGGGT	Doublets
Normal_TCCATAGATCTA	Doublets
Normal_TCCCAAAATCGA	Doublets
Normal_TCCCAACGGCTG	Doublets
Normal_TCCCAACGTTCA	Doublets
Normal_TCCCCAAAGCCT	Doublets
Normal_TCCCCCTGGGGA	cDC
Normal_TCCCCTATATTA	CD4Memory
Normal_TCCCGACGTTAC	Plasma
Normal_TCCCGGCCGCGG	Plasma
Normal_TCCCGTAAACTG	HSPC
Normal_TCCCTAACGAAT	Plasma
Normal_TCCCTGGCAACT	CD4Memory
Normal_TCCCTGTAGCAC	Doublets
Normal_TCCCTTCCAATT	Plasma
Normal_TCCCTTGCCCCC	Doublets
Normal_TCCGAAAAGATC	Doublets
Normal_TCCGAACGATAA	Doublets
Normal_TCCGCGAGCTCA	Doublets
Normal_TCCGGGTCACCC	cDC
Normal_TCCGGTCGCCCA	CD4Memory
Normal_TCCTACGATACC	Plasma
Normal_TCCTAGAAAGCG	CD4Memory
Normal_TCCTCAATTCCC	cDC
Normal_TCCTCCCCTCCT	Plasma
Normal_TCCTGAATCGCA	Doublets
Normal_TCCTGCGCACTC	HSPC
Normal_TCCTGTGGGGTA	HSPC
Normal_TCCTTAACAATT	Plasma
Normal_TCCTTCCATATC	HSPC
Normal_TCGAACCGCCCC	HSPC
Normal_TCGAACCGGTTT	Plasma
Normal_TCGAACTCTGCC	HSPC
Normal_TCGAACTTATAG	Plasma
Normal_TCGAAGATGGCT	Plasma
Normal_TCGAAGGGTTCC	CD4Memory
Normal_TCGAATCGTCTA	Doublets
Normal_TCGAATGAATGG	cDC
Normal_TCGACAAGCTGA	Doublets
Normal_TCGACGCGCAGA	Plasma
Normal_TCGAGATCCAAC	Plasma
Normal_TCGAGCAGCCCA	Plasma
Normal_TCGATTAGCGTC	Doublets
Normal_TCGATTCAGTCA	Plasma
Normal_TCGCATTTCTGG	Plasma
Normal_TCGCCAGCAGTC	Plasma
Normal_TCGCCCAGCAGA	Doublets
Normal_TCGCCTGGCCTA	Doublets
Normal_TCGCCTTCATAA	cDC
Normal_TCGCGGACGGTC	Doublets
Normal_TCGCGTACGAGA	CD4Memory
Normal_TCGCGTGGAGCG	CD4Memory
Normal_TCGCTAAACCGT	cDC
Normal_TCGCTACAATAT	Plasma
Normal_TCGCTCGATTGG	Plasma
Normal_TCGCTGCGCTAA	Doublets
Normal_TCGGAGATAGGT	Plasma
Normal_TCGGATACATCT	CD4Memory
Normal_TCGGATCGGCTG	Doublets
Normal_TCGGCTAGGGAT	cDC
Normal_TCGGGCTTACAT	Plasma
Normal_TCGGGTCAAGGC	Doublets
Normal_TCGGTAGAAACG	HSPC
Normal_TCGGTGCAACTG	HSPC
Normal_TCGGTGTCGAAA	Doublets
Normal_TCGGTGTGTGGA	Doublets
Normal_TCGGTTGTGAGT	Plasma
Normal_TCGGTTGTGGGG	Plasma
Normal_TCGTAAGCTTGC	Doublets
Normal_TCGTACAGAGGT	Plasma
Normal_TCGTAGCCCTAA	Plasma
Normal_TCGTCAATTGAA	Plasma
Normal_TCGTCGAGTGAC	Plasma
Normal_TCGTCGCGTGGA	Plasma
Normal_TCGTGAATAAGC	Plasma
Normal_TCGTGTCCCCCC	Doublets
Normal_TCGTTAAATCAG	Plasma
Normal_TCGTTTAGACAA	Plasma
Normal_TCGTTTATACTC	Doublets
Normal_TCTAATCCGAGG	Doublets
Normal_TCTACAGCACAT	CD8Naive
Normal_TCTACCTGGTAC	cDC
Normal_TCTAGCATACTC	GMP
Normal_TCTCATCAAGGG	Doublets
Normal_TCTCATGGGCCC	Doublets
Normal_TCTCCGCTGTTG	CD4Memory
Normal_TCTCCTCCTCAC	Doublets
Normal_TCTCGATTTAAA	HSPC
Normal_TCTCGCGGGGCC	Plasma
Normal_TCTCTAATCTTT	Plasma
Normal_TCTGAAAATCAG	Plasma
Normal_TCTGAAAGGCCG	Doublets
Normal_TCTGAAGCCGAA	Plasma
Normal_TCTGACACTGCC	Plasma
Normal_TCTGACGATTAC	CD8Naive
Normal_TCTGAGTAGAGG	CD4Memory
Normal_TCTGATAGTGGC	CD4Memory
Normal_TCTGCAGAACTA	Doublets
Normal_TCTGCGGTATCG	Doublets
Normal_TCTGGAACAAAG	Plasma
Normal_TCTGTTACTGAT	Plasma
Normal_TCTGTTGACGGG	Doublets
Normal_TCTGTTGCAACC	Plasma
Normal_TCTTAATCTTAA	Doublets
Normal_TCTTCCGTCAAG	Plasma
Normal_TCTTCGAATGCT	Plasma
Normal_TCTTCGAGGCCT	Doublets
Normal_TCTTCTATCTAC	Plasma
Normal_TCTTGATGCGCA	Plasma
Normal_TCTTGGGCCTTG	Doublets
Normal_TCTTGTCCAAGA	Doublets
Normal_TCTTTAGGCTCT	Doublets
Normal_TCTTTCGAACAT	Doublets
Normal_TCTTTGCACTCG	cDC
Normal_TCTTTGTGCCAA	Doublets
Normal_TCTTTTCTGCGG	Plasma
Normal_TGAAACCCGCGC	Plasma
Normal_TGAAAGCCGGGT	CD4Memory
Normal_TGAACACCTAAA	Doublets
Normal_TGAACCGTCCGA	Plasma
Normal_TGAACGAACTCT	Plasma
Normal_TGAACTAAACGA	Plasma
Normal_TGAAGAGACACC	Doublets
Normal_TGAAGCGGAGGC	Doublets
Normal_TGAAGGACGAGA	HSPC
Normal_TGAAGGCAATGT	Doublets
Normal_TGAAGTTGACAC	HSPC
Normal_TGAATAAGGAAG	Plasma
Normal_TGAATCGCCATA	Plasma
Normal_TGAATTCGTAGG	HSPC
Normal_TGACCACCTCTA	cDC
Normal_TGACCCCAAAGG	HSPC
Normal_TGACCTGGCTAA	Plasma
Normal_TGACGCCCGACC	Doublets
Normal_TGACTAACCCGT	Plasma
Normal_TGACTACCTATG	Plasma
Normal_TGACTGCTCACC	cDC
Normal_TGAGCTCATAAA	cDC
Normal_TGAGCTTCTACT	HSPC
Normal_TGAGGATGTCCC	HSPC
Normal_TGAGTAAAAGGT	Doublets
Normal_TGAGTCTCGACA	Plasma
Normal_TGATAATATGAA	Plasma
Normal_TGATCCGAATTG	HSPC
Normal_TGATCGTGGATC	Doublets
Normal_TGATGAGGGCAC	HSPC
Normal_TGATGCAATACG	cDC
Normal_TGATGGCTCATA	Plasma
Normal_TGATGGTATGGT	Doublets
Normal_TGATGGTGAGAA	Doublets
Normal_TGATTCCTCTAT	Doublets
Normal_TGATTCGAAGCC	HSPC
Normal_TGATTGGCGGGG	Doublets
Normal_TGATTGGTATCA	Plasma
Normal_TGATTGTTCCGG	HSPC
Normal_TGATTTGGTCTT	Doublets
Normal_TGCAAATAATCA	HSPC
Normal_TGCAACAGTCCA	CD4Memory
Normal_TGCAACGCCACC	CD4Memory
Normal_TGCAAGGCGTGC	HSPC
Normal_TGCAAGTTCATC	Plasma
Normal_TGCAATAGACGT	Doublets
Normal_TGCAATCGAGCA	Plasma
Normal_TGCACTAGTACG	CD4Memory
Normal_TGCAGACAGCAA	Plasma
Normal_TGCAGACCGTTC	Plasma
Normal_TGCAGGGAATAC	Doublets
Normal_TGCATGATGAGT	Doublets
Normal_TGCATGCGGGCT	Doublets
Normal_TGCATGTGTGGT	Doublets
Normal_TGCATTTCGGCA	Doublets
Normal_TGCCACGCGGGT	CD4Memory
Normal_TGCCACTTTCAG	Plasma
Normal_TGCCAGGAGCTA	Plasma
Normal_TGCCCATTGGAG	cDC
Normal_TGCCCGTGCCGA	HSPC
Normal_TGCCCTAGGCTG	cDC
Normal_TGCCCTATCAGT	Doublets
Normal_TGCCGCCACCAA	HSPC
Normal_TGCCGCCTGCCC	HSPC
Normal_TGCCGGCGAAAG	Doublets
Normal_TGCCGGGATTGA	Doublets
Normal_TGCCGGTCCCAT	Doublets
Normal_TGCCGTTCGTAG	Doublets
Normal_TGCCTAAGATCC	Plasma
Normal_TGCCTGATAATT	CD4Memory
Normal_TGCGACGGACAC	CD8Naive
Normal_TGCGAGAGCTCT	CD4Memory
Normal_TGCGATTCATAC	Doublets
Normal_TGCGATTTCAGT	Doublets
Normal_TGCGCGCCGATC	Doublets
Normal_TGCGTAGGTTTA	Doublets
Normal_TGCGTGTCTCTG	Plasma
Normal_TGCTACGGTTAC	Plasma
Normal_TGCTATTCTCAG	Plasma
Normal_TGCTCCGCAGCC	cDC
Normal_TGCTCCGCGTGT	Doublets
Normal_TGCTCCTTAGAG	Doublets
Normal_TGCTCTACCATT	Plasma
Normal_TGCTCTCTACCC	Plasma
Normal_TGCTTCAGAGAT	cDC
Normal_TGCTTCCGTATC	Plasma
Normal_TGCTTGAACGGT	cDC
Normal_TGCTTTATACTA	Plasma
Normal_TGGAACGGCTCA	Plasma
Normal_TGGAATGTAGAA	Doublets
Normal_TGGACTACTCGC	CD4Memory
Normal_TGGACTTTATCT	Doublets
Normal_TGGAGCTTAGAG	CD4Memory
Normal_TGGAGGTCTCGA	cDC
Normal_TGGAGGTGGAGT	Doublets
Normal_TGGAGTGACGGC	Doublets
Normal_TGGATCACACTT	CD4Memory
Normal_TGGATCTGAGGA	Doublets
Normal_TGGATGCCAAGC	Doublets
Normal_TGGATGCGACCC	cDC
Normal_TGGATGGAGAAT	Doublets
Normal_TGGATGTCCTAG	Doublets
Normal_TGGATTGACCCG	Doublets
Normal_TGGATTTGGAGT	Plasma
Normal_TGGCAATAACGC	Doublets
Normal_TGGCAGCTTTCA	Plasma
Normal_TGGCATCAATTC	cDC
Normal_TGGCATTTGCAA	Plasma
Normal_TGGCCGTACAAT	Doublets
Normal_TGGCGCTCTGAG	Plasma
Normal_TGGCTCCCTGCC	Plasma
Normal_TGGGAATATGCT	Plasma
Normal_TGGGACGTATAA	Plasma
Normal_TGGGCACAATGT	CD4Memory
Normal_TGGGCATGCTCT	Plasma
Normal_TGGGCGTGACCA	Plasma
Normal_TGGGGCCTTCCC	Doublets
Normal_TGGGGGGCTTTT	Doublets
Normal_TGGGTACGGTAC	Plasma
Normal_TGGTAACTTATG	pDC
Normal_TGGTAGACATTA	Plasma
Normal_TGGTATTTGTCA	cDC
Normal_TGGTCCAAACAG	CD8TermExh
Normal_TGGTCCTACTGG	Doublets
Normal_TGGTCTCAGTAT	cDC
Normal_TGGTGCGCGGTG	Doublets
Normal_TGGTGGCCTGTT	Doublets
Normal_TGGTGGTCAAGA	Doublets
Normal_TGGTGGTGGGGA	HSPC
Normal_TGGTGTCTCCCT	Plasma
Normal_TGGTTCCTGATT	Doublets
Normal_TGGTTTTGGGCA	CD8TermExh
Normal_TGTAACGCTCGC	Doublets
Normal_TGTAAGTTCTCC	HSPC
Normal_TGTAATTTATCC	Doublets
Normal_TGTACTGTAAGC	Plasma
Normal_TGTAGCCTTCAA	Plasma
Normal_TGTAGCGATAAA	Doublets
Normal_TGTATAGTGCGC	Plasma
Normal_TGTATATGGCCC	Doublets
Normal_TGTCAAATAGCA	cDC
Normal_TGTCAACGTGGA	CD4Memory
Normal_TGTCACTTCCAT	Doublets
Normal_TGTCATCGAACT	Plasma
Normal_TGTCATCGGCCC	Doublets
Normal_TGTCCAGCTCCC	CD4Memory
Normal_TGTCCCTCAATT	cDC
Normal_TGTCCGCCGGAT	Doublets
Normal_TGTCGAGTATCG	Doublets
Normal_TGTCGTGCGTTA	cDC
Normal_TGTCGTGGGATG	Doublets
Normal_TGTCTCCCCCGC	HSPC
Normal_TGTGACACGGCC	Doublets
Normal_TGTGCAGCGATA	CD4Memory
Normal_TGTGCCGCGCTC	HSPC
Normal_TGTGCGCAATCG	Doublets
Normal_TGTGCGTAAGCG	Doublets
Normal_TGTGCTGAAGAA	Plasma
Normal_TGTGCTTGGAGG	Doublets
Normal_TGTGGCACATGA	Plasma
Normal_TGTGGCTCAACA	Plasma
Normal_TGTGGGGTCTCC	Plasma
Normal_TGTGGGTAGGCT	Plasma
Normal_TGTGGTGACCGA	Doublets
Normal_TGTGTGGACTTT	Plasma
Normal_TGTGTTTGCGCG	Doublets
Normal_TGTTAAAGCTGT	Plasma
Normal_TGTTAACACCTA	cDC
Normal_TGTTACCGTGCC	CD4Memory
Normal_TGTTAGATCGCA	Doublets
Normal_TGTTATCATAGT	Doublets
Normal_TGTTCCCACTAA	Doublets
Normal_TGTTCGTCTCAG	CD4Memory
Normal_TGTTCGTGGGTC	Plasma
Normal_TGTTGGAGGTGC	Doublets
Normal_TGTTGTTTTTGG	HSPC
Normal_TGTTTCACCTAT	cDC
Normal_TGTTTCAGGGGG	Plasma
Normal_TGTTTCCTCTAA	Plasma
Normal_TGTTTCGACTAC	HSPC
Normal_TTAACCTGTACG	Doublets
Normal_TTAACTACTGTG	cDC
Normal_TTAACTTTTCCC	Doublets
Normal_TTAAGCTACTTC	Doublets
Normal_TTAAGGAACCCG	cDC
Normal_TTAAGGACCATG	HSPC
Normal_TTAAGGGAGTAG	HSPC
Normal_TTAAGGGTACCA	Plasma
Normal_TTAAGTGAATTA	Plasma
Normal_TTAATACTTGCG	B
Normal_TTACAATTGTGT	Doublets
Normal_TTACAGCAGCAG	Plasma
Normal_TTACATATTGAA	Doublets
Normal_TTACCCAGAGAG	Plasma
Normal_TTACCCCGCCCA	Plasma
Normal_TTACCGGTTATA	Doublets
Normal_TTACCTCCGCGT	CD4Memory
Normal_TTACGAGGGATG	HSPC
Normal_TTACGCTTAGCG	Plasma
Normal_TTACGCTTTAGA	Plasma
Normal_TTACTACGAGAA	cDC
Normal_TTACTAGAACAA	cDC
Normal_TTACTCACGGGC	Doublets
Normal_TTACTCGACTAA	Plasma
Normal_TTACTGCCACTC	Plasma
Normal_TTAGATCTCGAA	Plasma
Normal_TTAGATGCTGCG	Doublets
Normal_TTAGGAGGTACC	Plasma
Normal_TTAGGGGAAGCT	Plasma
Normal_TTAGGTCATGTG	cDC
Normal_TTAGTGTTGGGC	Plasma
Normal_TTAGTTCATATC	NK
Normal_TTATACATCTTA	Doublets
Normal_TTATCCATATAT	Doublets
Normal_TTATCCCGTCTG	Plasma
Normal_TTATGAAGCGGA	Plasma
Normal_TTATGCCCGACC	Doublets
Normal_TTATGCGTGCTA	cDC
Normal_TTATTATCAATA	cDC
Normal_TTATTGTTCTCC	HSPC
Normal_TTCAACCGCACC	Doublets
Normal_TTCAAGGATCAC	Doublets
Normal_TTCAATGGCCCC	CD4Memory
Normal_TTCACACCTGCG	CD8Memory
Normal_TTCACCAAATAG	Plasma
Normal_TTCAGAACGCAT	Plasma
Normal_TTCAGACGTACG	Doublets
Normal_TTCAGCCATAAT	Doublets
Normal_TTCAGGCCTGCA	Doublets
Normal_TTCAGGTGAAAC	cDC
Normal_TTCAGTGTTTAT	CD4Memory
Normal_TTCATCCGACTG	CD4Memory
Normal_TTCATTAGGCTG	Plasma
Normal_TTCCAAGCATGT	Doublets
Normal_TTCCATGGAGGC	Plasma
Normal_TTCCATGGGCGT	HSPC
Normal_TTCCGGTCAGGG	Doublets
Normal_TTCCTATTTTAC	Doublets
Normal_TTCCTCAACCCC	Doublets
Normal_TTCCTGATGTCT	Plasma
Normal_TTCGACGCTCAT	CD4Memory
Normal_TTCGCATATAAT	HSPC
Normal_TTCGCTGACCTA	HSPC
Normal_TTCGGCCGGTTA	CD4Memory
Normal_TTCGGTTAGTGA	CD4Memory
Normal_TTCGTAAAATGA	Plasma
Normal_TTCGTAAGTAAC	Plasma
Normal_TTCGTCCCTGTG	Plasma
Normal_TTCGTGTTAGAA	Plasma
Normal_TTCGTTTTTACC	CD4Memory
Normal_TTCTAACCGACC	Doublets
Normal_TTCTAAGCCGAT	Plasma
Normal_TTCTATACGATT	CD8Memory
Normal_TTCTGGAACTCT	Plasma
Normal_TTCTGTGATAAG	Doublets
Normal_TTCTTACCTCAG	Doublets
Normal_TTCTTGAGACAT	Doublets
Normal_TTGAAACTCCTT	Plasma
Normal_TTGAATAATTAC	CD4Memory
Normal_TTGACCTTTGCA	CD4Memory
Normal_TTGACGATCAAT	cDC
Normal_TTGACGTGCGAA	Doublets
Normal_TTGACTCGAATG	HSPC
Normal_TTGAGATCAGGG	cDC
Normal_TTGAGGTAAAGG	Plasma
Normal_TTGAGTTAGGCC	Doublets
Normal_TTGATAGAGCCA	cDC
Normal_TTGATGAACCTA	Doublets
Normal_TTGATTAGTCTC	Doublets
Normal_TTGCACCCTGTA	HSPC
Normal_TTGCACCTTGAC	Doublets
Normal_TTGCCCGGCGTC	Plasma
Normal_TTGCCCTCACAA	Doublets
Normal_TTGCCTAGCGGG	Plasma
Normal_TTGCCTTACTTA	Doublets
Normal_TTGCTCCTTGAA	Doublets
Normal_TTGCTTCGGAAC	Doublets
Normal_TTGGAGGCTAAT	Doublets
Normal_TTGGCATGGGAT	Plasma
Normal_TTGGCATTAAAT	Doublets
Normal_TTGGCGAGGCGT	cDC
Normal_TTGGCTAGTTGA	cDC
Normal_TTGGCTCGCCGC	Doublets
Normal_TTGGGATGTTGA	Doublets
Normal_TTGGGGTTACGG	Doublets
Normal_TTGGGTAGTAGC	CD4Memory
Normal_TTGGTAGTGCAT	cDC
Normal_TTGTAAGTGCGC	Plasma
Normal_TTGTAGGGTGCC	Doublets
Normal_TTGTATGGTATC	Plasma
Normal_TTGTTCGACATT	cDC
Normal_TTTAAGACCATG	Doublets
Normal_TTTACTTCAGAC	Plasma
Normal_TTTAGAATGCAT	CD4Memory
Normal_TTTAGATTCCAA	CD4Memory
Normal_TTTAGCCCCCTA	Doublets
Normal_TTTAGGCGATTT	Plasma
Normal_TTTAGGTATAGG	Plasma
Normal_TTTAGTTTGGTA	Plasma
Normal_TTTATAGGTTAG	Plasma
Normal_TTTATTAAACAA	Doublets
Normal_TTTATTTTGCTC	Plasma
Normal_TTTCAACCGTCA	Doublets
Normal_TTTCAATAAACC	Doublets
Normal_TTTCACATACAA	CD4Memory
Normal_TTTCACCTTGCC	Plasma
Normal_TTTCACTATCGT	Doublets
Normal_TTTCAGTAAGAT	Doublets
Normal_TTTCATTGGAGC	Plasma
Normal_TTTCCGTGCCTT	Doublets
Normal_TTTCGCGGATAT	Doublets
Normal_TTTCGCTCCACA	Plasma
Normal_TTTCGGTCAATA	CD4Memory
Normal_TTTCGGTGGGTC	Plasma
Normal_TTTCTAATTTGT	Plasma
Normal_TTTCTATGCCGT	Plasma
Normal_TTTGAAAGCGTA	Doublets
Normal_TTTGCGAGTGAG	Doublets
Normal_TTTGGAACTTGA	Doublets
Normal_TTTGGCCCATTA	Doublets
Normal_TTTGGCCGATGG	Doublets
Normal_TTTGGCGTCTAA	Doublets
Normal_TTTGGGTTCTGG	Doublets
Normal_TTTGTAAGTCGC	HSPC
Normal_TTTGTCTTGATT	cDC
Normal_TTTTATGTCCAT	Doublets
Normal_TTTTATTTCGAT	Plasma
Normal_TTTTCACCGTTT	Doublets
Normal_TTTTCGCCCAAG	Plasma
Normal_TTTTCGGAGAGC	Doublets
Normal_TTTTCTGCTGAT	cDC
Normal_TTTTGAACGAGC	Plasma
Normal_TTTTGACACACT	CD8TermExh
Normal_TTTTGCCAAAGA	Doublets
Normal_TTTTGGATGCAG	Plasma
Normal_TTTTGTGTTTCG	CD4Memory
Normal_TTTTTATCACAA	Plasma
NS810_AAAAAAATCAAC	Plasma
NS810_AAAAAACAATGA	HSPC
NS810_AAAAACCGGCAA	Plasma
NS810_AAAAAGTCGCCT	HSPC
NS810_AAAAAGTGGCAG	Plasma
NS810_AAAAATAAGACT	ProB
NS810_AAAATTGAGCAT	Doublets
NS810_AAACATGTCGCG	Doublets
NS810_AAACCAGCGGAA	HSPC
NS810_AAACCATATTCC	HSPC
NS810_AAACCCCTATTA	cDC
NS810_AAACCGGTACAG	HSPC
NS810_AAACGCGGCGCG	cDC
NS810_AAACGGGACGAG	Doublets
NS810_AAACGGGTGAGG	Plasma
NS810_AAACGTCGCGCC	Doublets
NS810_AAACTCGCGGAC	Mono
NS810_AAACTGCATTAT	Doublets
NS810_AAACTGGACGCT	cDC
NS810_AAAGACGGAAGC	CD4Memory
NS810_AAAGTCGCCCAA	Doublets
NS810_AAATGCGCCAAC	Doublets
NS810_AAATTAATGGAC	Doublets
NS810_AAATTCAATGTC	Doublets
NS810_AACAAATGTCAC	HSPC
NS810_AACAATATCGAA	HSPC
NS810_AACACCGTTCAG	Plasma
NS810_AACAGAGTTACA	Doublets
NS810_AACAGGATGTTG	pDC
NS810_AACATAACCTGT	Doublets
NS810_AACATAGCCTAA	HSPC
NS810_AACATATAAGTT	Plasma
NS810_AACCAGGGCTGT	Doublets
NS810_AACCCCCCATCT	cDC
NS810_AACCCCTTTTGC	HSPC
NS810_AACCCTTTTTCG	Doublets
NS810_AACCGCCGTGCT	Doublets
NS810_AACGAATACCCA	Doublets
NS810_AACGACCGTACC	Doublets
NS810_AACGGACACGTG	Plasma
NS810_AACGGTATCGAG	Plasma
NS810_AACGTAATTATG	Doublets
NS810_AACGTGTACAGT	HSPC
NS810_AACGTTCGCGTC	Doublets
NS810_AACTAAAGCCGC	Doublets
NS810_AACTTGAGATAG	Plasma
NS810_AACTTGTCTTTC	Doublets
NS810_AACTTTTGGCTT	Doublets
NS810_AAGAAAGCACGG	Doublets
NS810_AAGAAAGCTTCA	HSPC
NS810_AAGAACCTATTA	Plasma
NS810_AAGAATGTCTAC	Doublets
NS810_AAGACACCCTTA	CD8TermExh
NS810_AAGACAGCGAGT	cDC
NS810_AAGACCATCTCC	cDC
NS810_AAGACGTGGTGG	Plasma
NS810_AAGCAGTGGTAT	HSPC
NS810_AAGCCCATTCCT	Plasma
NS810_AAGCTGATCATA	Plasma
NS810_AAGCTGCATGGT	Doublets
NS810_AAGGCCTAGGTG	Doublets
NS810_AAGGCGCTGCCT	Doublets
NS810_AAGGCTATATGT	Doublets
NS810_AAGTATGATAAA	Plasma
NS810_AAGTCACTCTAT	CD8Memory
NS810_AAGTCAGCTCAT	Doublets
NS810_AAGTCCTGGGAA	Plasma
NS810_AAGTCGGCCTCT	HSPC
NS810_AAGTGGCCGATG	Doublets
NS810_AAGTGGCGAAAA	HSPC
NS810_AATAAAGATCTC	Doublets
NS810_AATAACTATTGT	Plasma
NS810_AATAACTCTCCG	Plasma
NS810_AATAATGCAATT	HSPC
NS810_AATACCCTTGAA	Doublets
NS810_AATAGAGCCACG	Doublets
NS810_AATATATACAAT	Plasma
NS810_AATATTGATGAC	HSPC
NS810_AATCAAATCGCT	cDC
NS810_AATCAAGATTAG	Doublets
NS810_AATCATGCCGCG	Doublets
NS810_AATCCACCATCG	Doublets
NS810_AATCCGCATATG	Doublets
NS810_AATCGGTTAAGT	Plasma
NS810_AATCTAGACGTG	HSPC
NS810_AATCTCTCTTTC	Doublets
NS810_AATGAAAAGCCG	Doublets
NS810_AATGCAATAGTT	Doublets
NS810_AATGCCCCATGC	Plasma
NS810_AATGCTAAATGG	cDC
NS810_AATGCTTCCTGC	HSPC
NS810_AATTGAGGAATC	Doublets
NS810_AATTGGTCTACT	Doublets
NS810_AATTTATGCGGA	Plasma
NS810_AATTTATGTTTT	Plasma
NS810_ACAAACCGTACT	Plasma
NS810_ACAAATCACGGC	Plasma
NS810_ACAACGCGGCAA	Plasma
NS810_ACAAGGAAGCAC	Doublets
NS810_ACAATAAGATTC	HSPC
NS810_ACAATGAGAGCG	Doublets
NS810_ACAATGCCCGTC	Plasma
NS810_ACAATTAACCCG	cDC
NS810_ACACTTACTAAG	Doublets
NS810_ACACTTGGTCAT	Doublets
NS810_ACAGCGCCTGTG	CD4Memory
NS810_ACAGGTATTGTC	HSPC
NS810_ACATATTCGACG	HSPC
NS810_ACATCAGAATGT	Doublets
NS810_ACATTTTTATTT	Doublets
NS810_ACCAACGTTGCG	cDC
NS810_ACCAAGTAGACG	Plasma
NS810_ACCAGGCTCATA	Doublets
NS810_ACCATCCGCTAG	Doublets
NS810_ACCCATCTCTTC	cDC
NS810_ACCCCGCGAGAG	Doublets
NS810_ACCCGCGGCCAG	Plasma
NS810_ACCCGGCGAGGG	Doublets
NS810_ACCCTCGGGAAC	Doublets
NS810_ACCCTGAGCAAC	pDC
NS810_ACCGACATTGGG	Doublets
NS810_ACCGGCACAGTT	HSPC
NS810_ACCGGTGGAGGG	HSPC
NS810_ACCGTATGCCGT	Doublets
NS810_ACCGTGCTTATC	HSPC
NS810_ACCTCAAGGAAC	Doublets
NS810_ACCTCATGGTGT	Doublets
NS810_ACCTCGCTTTAT	HSPC
NS810_ACCTCGTGGGAG	HSPC
NS810_ACCTCTTACGCC	CD4Memory
NS810_ACCTCTTATTAG	HSPC
NS810_ACGACGACAGAG	Doublets
NS810_ACGAGGGGGTCG	Doublets
NS810_ACGAGTTTATGA	Doublets
NS810_ACGATGGGCGTG	Doublets
NS810_ACGCAACATAAT	Doublets
NS810_ACGCACTACTTT	Plasma
NS810_ACGCCCTTCCCC	Doublets
NS810_ACGCCGATCCAT	Plasma
NS810_ACGCCGCCGACG	Plasma
NS810_ACGCTGATTGAA	Doublets
NS810_ACGGACCTTGGT	Doublets
NS810_ACGGCAACCACA	NK
NS810_ACGGGATTGTAC	Plasma
NS810_ACGGGTGTCGCT	Plasma
NS810_ACGGGTTGACTC	Doublets
NS810_ACGGTTATTCTC	Plasma
NS810_ACGGTTGCCTCC	HSPC
NS810_ACGTAAACGCTG	Doublets
NS810_ACGTAGTGAAGA	Plasma
NS810_ACGTCAGGTCGC	Plasma
NS810_ACGTGACGGCAG	cDC
NS810_ACGTGCGTAACT	HSPC
NS810_ACGTTACGGGGA	HSPC
NS810_ACGTTAGCCGAA	CD4Memory
NS810_ACGTTAGGTGAA	cDC
NS810_ACGTTATGAGTG	Plasma
NS810_ACTAACCCACTG	Doublets
NS810_ACTAACTCCGAG	Doublets
NS810_ACTAATCAAGAT	HSPC
NS810_ACTACCCATCTA	CD4Memory
NS810_ACTACCTGGGTA	cDC
NS810_ACTACCTGTCGC	Plasma
NS810_ACTAGAACTAGA	Plasma
NS810_ACTAGCCTGTCG	HSPC
NS810_ACTAGTTAAGGT	Doublets
NS810_ACTATCCCCGCG	Plasma
NS810_ACTCATCCTTGT	Plasma
NS810_ACTCGAGTTCGC	Doublets
NS810_ACTCGATTGCTC	Doublets
NS810_ACTCTAAGACGC	Doublets
NS810_ACTGAACGAATG	HSPC
NS810_ACTGAGAAGCAA	CD8TermExh
NS810_ACTGCCACTTTC	Doublets
NS810_ACTGCCAGCGAC	Plasma
NS810_ACTGGAGGTCGC	Plasma
NS810_ACTGGCTTAAAA	Plasma
NS810_ACTGGTACATAG	Doublets
NS810_ACTGTACGTACG	HSPC
NS810_ACTGTAGTTTTT	Doublets
NS810_ACTTAAGCTTTA	Plasma
NS810_ACTTAATACCTA	Doublets
NS810_ACTTAATTAGAT	Doublets
NS810_ACTTAGACACTG	Doublets
NS810_ACTTCGCAACGC	Doublets
NS810_ACTTGGCAGCAT	Plasma
NS810_ACTTGGTCATAG	Doublets
NS810_ACTTTACTCGGG	Doublets
NS810_ACTTTATCACGA	HSPC
NS810_ACTTTTCCACAC	Plasma
NS810_ACTTTTTCTCAG	HSPC
NS810_AGAAAACCGTAG	Plasma
NS810_AGAAACAGTTGC	Plasma
NS810_AGAAACCGCGGC	HSPC
NS810_AGAAAGGATGGT	Plasma
NS810_AGAAAGGTTGGA	Plasma
NS810_AGAAATTCCAAG	pDC
NS810_AGAACACTTAAG	Plasma
NS810_AGAACTATTGCA	Doublets
NS810_AGAAGAAATTCC	Doublets
NS810_AGAATCCCAACC	HSPC
NS810_AGAATCCTAGGA	Doublets
NS810_AGACACTGATAC	HSPC
NS810_AGACATCTTGTC	Plasma
NS810_AGACCACCACAC	pDC
NS810_AGACCTTTACGA	Doublets
NS810_AGACGAGGTATA	Doublets
NS810_AGACGCGCTTTA	Doublets
NS810_AGACTATATTAC	HSPC
NS810_AGAGAAACTCGA	Plasma
NS810_AGAGAGTCAGGT	Plasma
NS810_AGAGAGTTGGAA	cDC
NS810_AGAGTAGCTATC	Plasma
NS810_AGATCAGACCTA	Doublets
NS810_AGATCGCAAGAA	CD8TermExh
NS810_AGATGGTCTTGC	Plasma
NS810_AGATTGCTCCAG	Plasma
NS810_AGCAAACCGCGA	Doublets
NS810_AGCAAAGGATCA	Doublets
NS810_AGCAACATTATT	HSPC
NS810_AGCAATAGCACA	Plasma
NS810_AGCACGCACCAA	Doublets
NS810_AGCATGTGCAGC	HSPC
NS810_AGCCAAAACCTT	Doublets
NS810_AGCCAAAGAAAG	Doublets
NS810_AGCCACAACTAT	Plasma
NS810_AGCCGTATTGTT	HSPC
NS810_AGCGAAAACTGG	HSPC
NS810_AGCGAATGCACG	CD4Memory
NS810_AGCGAGACATCC	Plasma
NS810_AGCGAGGCGTTG	Doublets
NS810_AGCGGGGGCTGC	Doublets
NS810_AGCGTGAGCGTA	HSPC
NS810_AGCTGCGCATCC	Plasma
NS810_AGCTGGAAGGTG	Plasma
NS810_AGCTTCACGGGC	cDC
NS810_AGGAATAATTCA	HSPC
NS810_AGGACTGCAAAA	cDC
NS810_AGGAGGTCACGT	cDC
NS810_AGGATCAGCAGA	Doublets
NS810_AGGATTCTATTT	CD4Memory
NS810_AGGCATGTAGCG	Plasma
NS810_AGGCGAGTCTAT	Doublets
NS810_AGGCGGGCGAGA	CD8TermExh
NS810_AGGGATGAGATG	ncMono
NS810_AGGGGTCACAAA	cDC
NS810_AGGTACGCCAAC	Plasma
NS810_AGGTACTGTCCA	cDC
NS810_AGGTGGTGATGT	Plasma
NS810_AGGTTAGTTCGC	HSPC
NS810_AGTAAATGCCTT	HSPC
NS810_AGTAACTGGTGT	Doublets
NS810_AGTAGCTTTAAG	pDC
NS810_AGTAGGGCACTT	Plasma
NS810_AGTCACCGAGAT	CD4Memory
NS810_AGTCATCGAGGC	HSPC
NS810_AGTCGCTCCAGA	Plasma
NS810_AGTCTCCCATAT	HSPC
NS810_AGTCTTCGATCT	Doublets
NS810_AGTGATGAGGCG	Doublets
NS810_AGTGGTTCCCAA	HSPC
NS810_AGTGTCGCATAA	Plasma
NS810_AGTTCAAAGAGC	Doublets
NS810_AGTTGCTCTTAG	Plasma
NS810_AGTTTCTTACCG	pDC
NS810_AGTTTGCATTAA	Doublets
NS810_AGTTTGGGGATG	Doublets
NS810_ATAAAACGCCAC	HSPC
NS810_ATAAAAGTTAGC	HSPC
NS810_ATAAAGGTAGTA	cDC
NS810_ATAACATGCCAC	Doublets
NS810_ATAATCCATACC	pDC
NS810_ATACAACACGCG	Doublets
NS810_ATACATCCCTTT	HSPC
NS810_ATACCAGGACTA	HSPC
NS810_ATACCATCACGG	Doublets
NS810_ATACGACTAGCT	Doublets
NS810_ATACGCATGACG	Doublets
NS810_ATACGCCGCCGC	Plasma
NS810_ATACGGTGACAC	CD8TermExh
NS810_ATAGCGCCCTAC	Doublets
NS810_ATAGCTTTTTCG	Doublets
NS810_ATATAAATATTC	Doublets
NS810_ATATCAGTAATC	Doublets
NS810_ATATCGGCGGGT	Plasma
NS810_ATATGGGGAAGA	Plasma
NS810_ATATTGCTTGGT	Plasma
NS810_ATATTGGCGTTC	Doublets
NS810_ATCACTAACAGC	Doublets
NS810_ATCAGAAACTCT	Plasma
NS810_ATCAGATACGGC	Plasma
NS810_ATCATAACCGCC	Plasma
NS810_ATCCACATTCTT	Plasma
NS810_ATCCCCGCCCAT	HSPC
NS810_ATCCCTCTTGGA	HSPC
NS810_ATCCTGAAAGAG	Doublets
NS810_ATCGAAAATCAC	pDC
NS810_ATCGAACAGAGA	HSPC
NS810_ATCGCGTGCAAA	Doublets
NS810_ATCGCTTGTGCG	Plasma
NS810_ATCGTGAAGTGG	Doublets
NS810_ATCTCCCACTGC	Plasma
NS810_ATCTCGAGTTCT	Plasma
NS810_ATCTCTGCCCTT	HSPC
NS810_ATCTGAACGGGT	HSPC
NS810_ATCTGCGGTCGA	Doublets
NS810_ATCTGTAATTGA	HSPC
NS810_ATCTTTGGAGAA	Plasma
NS810_ATGAGAGAAGGC	CD4Memory
NS810_ATGAGGAGGAGC	cDC
NS810_ATGAGTGTCACC	Plasma
NS810_ATGATCAGGAGA	Doublets
NS810_ATGATGCGCGAA	HSPC
NS810_ATGATGGGCAAG	Doublets
NS810_ATGCCCTTGAAA	HSPC
NS810_ATGCCTACGATC	CD4Memory
NS810_ATGCCTGAGAAG	cDC
NS810_ATGCTCGGAACA	HSPC
NS810_ATGGCAAGTGAT	CD4Memory
NS810_ATGGCCCATTTA	Plasma
NS810_ATGGCGGCAAGC	Doublets
NS810_ATGGGGAGGGCG	Plasma
NS810_ATGGTCCCGGCT	Doublets
NS810_ATGGTCCGCATC	Doublets
NS810_ATGTAGATTAAG	Doublets
NS810_ATGTAGGGCTCA	Plasma
NS810_ATGTGCGAGTCA	Doublets
NS810_ATGTGCGCACGG	Doublets
NS810_ATTACACGACGT	Doublets
NS810_ATTACTTAAACG	Doublets
NS810_ATTATCAACCCA	cDC
NS810_ATTCAACAGCCG	cDC
NS810_ATTCACTTGCTT	Doublets
NS810_ATTCATGTTTAA	Doublets
NS810_ATTCATTCTTTT	Doublets
NS810_ATTCTCAATACC	ProB
NS810_ATTCTTATCGTC	Doublets
NS810_ATTCTTGTAAAT	Doublets
NS810_ATTGACTCTAGC	HSPC
NS810_ATTGACTTTCGA	HSPC
NS810_ATTGCAAAGATC	pDC
NS810_ATTGTTCTGTAG	Doublets
NS810_ATTTATTTAGGT	HSPC
NS810_ATTTCTATGTTC	cDC
NS810_ATTTTCGGCCCC	Plasma
NS810_CAAAACCTTGTC	HSPC
NS810_CAAACATCCTGG	Doublets
NS810_CAAACTATCTTG	Plasma
NS810_CAAATGTATTAC	Doublets
NS810_CAACAGTATGTG	cDC
NS810_CAACTGGCCATC	Doublets
NS810_CAAGGAGTTGAG	Doublets
NS810_CAAGGGTGTCCA	Doublets
NS810_CAAGGTGGGAAG	Doublets
NS810_CAATAGACGTTC	Plasma
NS810_CAATCCGACCGC	Doublets
NS810_CAATCTCGCACA	Plasma
NS810_CAATGATAAGTT	Doublets
NS810_CAATGTCTAACA	Plasma
NS810_CAATTACGAAAG	Doublets
NS810_CACACGAAATAT	Doublets
NS810_CACACTGCAAGT	Doublets
NS810_CACAGATCGGGC	HSPC
NS810_CACAGGTATCTA	Doublets
NS810_CACATCACGGCT	Doublets
NS810_CACCACACATCC	Doublets
NS810_CACCACTTCAGC	Doublets
NS810_CACCAGAAGATG	Doublets
NS810_CACCCAGTCACG	Doublets
NS810_CACCCCGGCACT	Plasma
NS810_CACCGACTCGTC	Doublets
NS810_CACCGCTAGTAT	Doublets
NS810_CACCGGCTTAAC	pDC
NS810_CACGAAAACACG	Doublets
NS810_CACGAGTATGGT	Plasma
NS810_CACGATTCATTA	Doublets
NS810_CACGATTTGCAA	HSPC
NS810_CACGCAAGTCGC	Plasma
NS810_CACGGATCATGA	Doublets
NS810_CACGGCCCCCCA	HSPC
NS810_CACGGTACTTTG	Plasma
NS810_CACGGTGTGCTG	HSPC
NS810_CACGTAACAGAA	Doublets
NS810_CACGTCTACGTC	Plasma
NS810_CACTAACTATTT	HSPC
NS810_CACTAGGATTTT	Plasma
NS810_CACTCACTATCA	Doublets
NS810_CACTGATGCAAC	pDC
NS810_CACTGCCTACCC	Doublets
NS810_CACTTGTCTTGA	Doublets
NS810_CAGAAGCACGGG	Doublets
NS810_CAGACACCGGTT	HSPC
NS810_CAGACATTCGCA	Doublets
NS810_CAGAGATAGATG	Doublets
NS810_CAGAGGCCTTCG	Doublets
NS810_CAGCCGCTATCC	Plasma
NS810_CAGCGCGCGGGC	HSPC
NS810_CAGCGGACCTCG	ProB
NS810_CAGCTGAATTAT	HSPC
NS810_CAGCTTAGACTG	Doublets
NS810_CAGGACCACGTC	HSPC
NS810_CAGGACCCCGTA	Doublets
NS810_CAGGTGCTACTC	HSPC
NS810_CAGGTGGTACGG	Doublets
NS810_CAGTAAGAACCA	Doublets
NS810_CAGTCCTAAGGG	Plasma
NS810_CAGTCTCCCTTT	CD4Memory
NS810_CAGTGAAGTATT	HSPC
NS810_CAGTGACACTCT	HSPC
NS810_CAGTGCTAGAAG	Doublets
NS810_CAGTGGGTCGGG	Doublets
NS810_CAGTGTCGTTGT	Doublets
NS810_CAGTTAGCGACC	Doublets
NS810_CAGTTCATCTGT	Doublets
NS810_CATACAAAATAG	Plasma
NS810_CATACAAATTCG	Plasma
NS810_CATACCTTGTCG	HSPC
NS810_CATATACTAACA	HSPC
NS810_CATATCCATGCT	Doublets
NS810_CATATTGTCTAA	Plasma
NS810_CATATTTGGAAC	Doublets
NS810_CATCAAACGACC	CD4Memory
NS810_CATCAATGCTTA	HSPC
NS810_CATCATGTTGAA	cDC
NS810_CATCCAATTGAG	HSPC
NS810_CATCCCTATTGC	Doublets
NS810_CATCCGTAACAG	cDC
NS810_CATCCTACATCG	Doublets
NS810_CATCGTGGGACC	cDC
NS810_CATCTAGAAAGC	Doublets
NS810_CATCTCTCTATA	Doublets
NS810_CATGAACGCACG	Doublets
NS810_CATGCATATCCG	HSPC
NS810_CATGCCGCTCAG	Plasma
NS810_CATGGATTAGGG	Plasma
NS810_CATGTGACTCAA	Plasma
NS810_CATGTTAATCGA	CD4Memory
NS810_CATTAATGATTG	Doublets
NS810_CATTACGTGCCG	cDC
NS810_CATTCGGCTGCT	Plasma
NS810_CATTGAGTTTTT	Doublets
NS810_CATTGTCTTACG	HSPC
NS810_CATTTGGATTAA	HSPC
NS810_CATTTGTTCGAA	cDC
NS810_CCAAAATTGCAG	Doublets
NS810_CCAAACTGCAAG	Plasma
NS810_CCAAGGTGTGAT	Doublets
NS810_CCAATCATGTTT	cDC
NS810_CCAATGTATTAA	Doublets
NS810_CCACACAACCAA	HSPC
NS810_CCACACGACAGT	Plasma
NS810_CCACAGAGTACG	Doublets
NS810_CCACATGCTAGG	CD4Memory
NS810_CCACCCGATGCC	HSPC
NS810_CCACGCACACGT	HSPC
NS810_CCACGGGCTTGC	Doublets
NS810_CCACTAAGTGTA	Doublets
NS810_CCACTGGCGTAT	HSPC
NS810_CCAGCTACAGCC	Mono
NS810_CCAGCTGCCTAC	Plasma
NS810_CCAGGCAAACGA	Doublets
NS810_CCAGGCCATTAG	Doublets
NS810_CCAGGTGAGGCG	Plasma
NS810_CCAGTCACATTA	Plasma
NS810_CCAGTGAACTTT	pDC
NS810_CCAGTTTATCTG	Doublets
NS810_CCATACATGATG	HSPC
NS810_CCATAGTGGTAT	Plasma
NS810_CCATCAATATAT	HSPC
NS810_CCATCCCCTGAG	Plasma
NS810_CCATGGTACACC	HSPC
NS810_CCATTGGCAATC	Doublets
NS810_CCCACTATCCGT	Doublets
NS810_CCCAGACTACCA	Plasma
NS810_CCCATAACAATT	Plasma
NS810_CCCATGCAACAC	HSPC
NS810_CCCCATACACCG	Plasma
NS810_CCCCCGCGAATG	Plasma
NS810_CCCCCGTGGCCT	HSPC
NS810_CCCCGGCCGCAC	Plasma
NS810_CCCCGTTCGCTC	HSPC
NS810_CCCCTACTAATC	Doublets
NS810_CCCCTGGTCCTA	Plasma
NS810_CCCGATTGACAG	Doublets
NS810_CCCGCCCCAGTG	cDC
NS810_CCCGCCGCGCTC	HSPC
NS810_CCCGCGCCCACG	HSPC
NS810_CCCGCGGTGAGG	Doublets
NS810_CCCGCTGCTGGC	Plasma
NS810_CCCGGACCTCCA	Doublets
NS810_CCCTAAGTGCCC	HSPC
NS810_CCCTCAATAATA	HSPC
NS810_CCCTCGGCGTTC	HSPC
NS810_CCCTTATGTGCG	Doublets
NS810_CCGAAGCTGTTC	Doublets
NS810_CCGACGGTAGCT	CD8TermExh
NS810_CCGAGCTTTACT	Doublets
NS810_CCGAGTCGAGCA	Plasma
NS810_CCGATATATATG	Plasma
NS810_CCGATCCTGTAC	Plasma
NS810_CCGATGATCCTT	HSPC
NS810_CCGCACGACAGG	Plasma
NS810_CCGCTTATTAAA	Plasma
NS810_CCGGAAATGGGA	HSPC
NS810_CCGGAATCGCGA	cDC
NS810_CCGGGCAGGCTG	Doublets
NS810_CCGGGTAAGTGA	HSPC
NS810_CCGTAAACCGGT	CD8TermExh
NS810_CCGTCACAGGAC	Doublets
NS810_CCGTCACCCCGG	HSPC
NS810_CCGTCCCATCGG	Doublets
NS810_CCGTCTAGGGTG	cDC
NS810_CCGTCTCATTCT	Doublets
NS810_CCGTGCTCCGAT	cDC
NS810_CCGTGGCCCCCG	Doublets
NS810_CCGTTAATCCCT	Doublets
NS810_CCGTTTGACTAA	Plasma
NS810_CCTAAGCAGTGG	Doublets
NS810_CCTACATCTCCG	Plasma
NS810_CCTACGCTACTG	Doublets
NS810_CCTACGGGGGGA	Plasma
NS810_CCTAGGAAGTCA	Doublets
NS810_CCTAGTACTGCT	HSPC
NS810_CCTAGTCTGATT	Plasma
NS810_CCTATTATTACG	Doublets
NS810_CCTATTGTTGCG	CD4Memory
NS810_CCTCAATCTAAG	Doublets
NS810_CCTCCACCGAGA	Doublets
NS810_CCTCCCCGGTAA	Doublets
NS810_CCTCCGATGCTG	Doublets
NS810_CCTCCGCCATCT	HSPC
NS810_CCTCCGCTGGTA	HSPC
NS810_CCTCGATTACCT	HSPC
NS810_CCTCGTGGCGAA	Doublets
NS810_CCTCTGGAACTT	ProB
NS810_CCTCTTACCAGA	Doublets
NS810_CCTGATAGGTAG	Doublets
NS810_CCTGCCGCTTGG	Doublets
NS810_CCTGCTTCGACG	Doublets
NS810_CCTGGGGTTTCA	HSPC
NS810_CCTGGGTGCGCA	Doublets
NS810_CCTGTCAACCCA	Plasma
NS810_CCTGTTCCTAGC	cDC
NS810_CCTTATCTCGGC	Doublets
NS810_CCTTCAAGGCTT	Doublets
NS810_CCTTCAATCACC	Plasma
NS810_CCTTCACACCTT	Doublets
NS810_CCTTCAGAGGGG	Doublets
NS810_CCTTCCCTCGGG	HSPC
NS810_CCTTCGGGTGAA	HSPC
NS810_CCTTGGAGCTTA	Doublets
NS810_CCTTGTACTCCG	HSPC
NS810_CCTTTGTATCGT	Doublets
NS810_CCTTTTCATCCG	Doublets
NS810_CGAAAAAAAAAC	HSPC
NS810_CGAAATAAAACT	Doublets
NS810_CGAACAGCGAAA	HSPC
NS810_CGAACAGGGTGC	HSPC
NS810_CGAACGGGACTC	Doublets
NS810_CGAACTCCTCGA	Doublets
NS810_CGAAGTAAAGTT	Plasma
NS810_CGAATAAAAAGG	Plasma
NS810_CGAATGTGTTTA	HSPC
NS810_CGACGACTATAA	Plasma
NS810_CGAGGATTCTGT	Doublets
NS810_CGAGTGGTCTGA	Doublets
NS810_CGAGTTGAAGCA	cDC
NS810_CGATCGGGCCCT	Plasma
NS810_CGATCTCGTTGT	Doublets
NS810_CGATGCAAACAG	Doublets
NS810_CGATTAACTATG	HSPC
NS810_CGATTCAAGGTA	HSPC
NS810_CGATTTAGTGAC	Plasma
NS810_CGCAGCTACCAC	HSPC
NS810_CGCAGTCAAGAT	Plasma
NS810_CGCAGTCGCTCC	HSPC
NS810_CGCATGATCCAA	HSPC
NS810_CGCATGCATTCA	Doublets
NS810_CGCCGAAGCTAT	cDC
NS810_CGCCGCACGCGT	Doublets
NS810_CGCGACCAACGG	Doublets
NS810_CGCGCTAGTCTA	Plasma
NS810_CGCGTGAAATCA	HSPC
NS810_CGCTAGGTTGCG	Doublets
NS810_CGCTCGTTGTTA	HSPC
NS810_CGCTCTTGTAGT	cDC
NS810_CGCTTCGGGTCT	Doublets
NS810_CGGAATATTATG	Plasma
NS810_CGGAGATTGTGC	cDC
NS810_CGGAGTCCGAGC	HSPC
NS810_CGGATCGGGGGT	HSPC
NS810_CGGATGGTACCC	HSPC
NS810_CGGCATCAGTAA	Doublets
NS810_CGGCCGTTGACA	Doublets
NS810_CGGCCTAGTTAG	Doublets
NS810_CGGCGCTTTGTT	HSPC
NS810_CGGCTTAACTGT	Plasma
NS810_CGGGAGCAGTGT	HSPC
NS810_CGGGCGTCTCTA	HSPC
NS810_CGGGGTATACTA	Doublets
NS810_CGGGTTCTGCTG	HSPC
NS810_CGGTAACCCTTC	Doublets
NS810_CGGTGCATGAGA	Doublets
NS810_CGGTGCGCACAA	Doublets
NS810_CGGTGTCGCGAC	Doublets
NS810_CGGTTAGGTGCA	HSPC
NS810_CGTAAGAAAAAG	Plasma
NS810_CGTAATGCAGAA	Plasma
NS810_CGTACAACAATG	HSPC
NS810_CGTACGAATCTA	Doublets
NS810_CGTAGACATAAA	Plasma
NS810_CGTAGCCTGTCA	cDC
NS810_CGTAGGATTGTT	Plasma
NS810_CGTCAAGCACTA	Doublets
NS810_CGTCCCAGAGGG	Doublets
NS810_CGTCCGGATGTT	HSPC
NS810_CGTCCGTCGATC	Doublets
NS810_CGTCTGAATATG	CD8TermExh
NS810_CGTGCTCCGAGT	cDC
NS810_CGTGGGACAGAG	HSPC
NS810_CGTGGTTCCCCA	Doublets
NS810_CGTGTTTCGATG	cDC
NS810_CGTTAGGCCTCA	Plasma
NS810_CGTTAGTAATAA	HSPC
NS810_CGTTATCATCAG	B
NS810_CGTTCATTCCGC	Plasma
NS810_CGTTGAGAAAGC	HSPC
NS810_CGTTGAGTGTCA	HSPC
NS810_CGTTGTGATTAT	ProB
NS810_CTAAATGCGTTT	Doublets
NS810_CTAAGCAGTGGT	Doublets
NS810_CTAAGTGTGCCG	Plasma
NS810_CTACACTGTCCT	HSPC
NS810_CTACGACAGTCG	Plasma
NS810_CTACGGTTACAC	Plasma
NS810_CTACTGAGTATT	HSPC
NS810_CTACTTGGAGAA	HSPC
NS810_CTAGAAGATGTA	Plasma
NS810_CTAGATAGGGCG	Plasma
NS810_CTAGATCTTTAC	Plasma
NS810_CTAGCTTCTATG	Doublets
NS810_CTAGGCGTATAA	Doublets
NS810_CTAGTGGTATCC	Plasma
NS810_CTATACAATACA	Doublets
NS810_CTATACCAGGGC	CD4Memory
NS810_CTATATGCTATT	Plasma
NS810_CTATCGACACTG	Doublets
NS810_CTATTGGGGTGG	Doublets
NS810_CTATTGTCGTAC	Doublets
NS810_CTCACGACCCCG	CD8Naive
NS810_CTCATACCAAGT	Plasma
NS810_CTCATAGAGTGA	Doublets
NS810_CTCCAACCGGGA	CD4Memory
NS810_CTCCAAGCGACC	Plasma
NS810_CTCCGAACCCGT	Doublets
NS810_CTCCGCGAACAC	Doublets
NS810_CTCCTCGGCGGA	cDC
NS810_CTCGAAGAGGCA	Plasma
NS810_CTCGACACCTCA	Doublets
NS810_CTCGCCGAGGGG	Doublets
NS810_CTCGGGGGTTCA	HSPC
NS810_CTCGTAGTCGAC	Plasma
NS810_CTCTAATGCGAA	ProB
NS810_CTCTCCGACGGT	Plasma
NS810_CTCTGAAGCAGT	Doublets
NS810_CTCTGGTATCTA	HSPC
NS810_CTCTTAAAGGGT	Plasma
NS810_CTCTTAGATGCT	Plasma
NS810_CTGAAGCGAGTA	Plasma
NS810_CTGAATCACGTT	Plasma
NS810_CTGAGACATTCT	Doublets
NS810_CTGAGACCTGGA	Doublets
NS810_CTGATTAGTATC	HSPC
NS810_CTGCACTCCACG	Doublets
NS810_CTGCATCGCGCA	Plasma
NS810_CTGCATTTATCT	cDC
NS810_CTGCGAGATGCC	HSPC
NS810_CTGCGCGCAGGA	Plasma
NS810_CTGCGGGCGCGG	Doublets
NS810_CTGGAACGCTCC	Plasma
NS810_CTGGACGGCGGA	Plasma
NS810_CTGGCACATCCA	Plasma
NS810_CTGGCAGCCGAT	Doublets
NS810_CTGGGTCTCCAA	HSPC
NS810_CTGGGTGCATAC	Plasma
NS810_CTGGTTTCGCTG	Plasma
NS810_CTGTCTTAGGGA	Plasma
NS810_CTGTGAAGCTTG	Doublets
NS810_CTGTTCCATCCC	Plasma
NS810_CTGTTGACAAAT	cDC
NS810_CTTAACACGTGT	HSPC
NS810_CTTACCATGTAC	Doublets
NS810_CTTACTGATTTC	Plasma
NS810_CTTACTGGAAGG	ProB
NS810_CTTATTGTATAA	Doublets
NS810_CTTCCGGGTGGA	Doublets
NS810_CTTCCTTTTTCA	Plasma
NS810_CTTCGCTACGCT	Plasma
NS810_CTTCTACGGGCG	Doublets
NS810_CTTGAGTTGAAC	Doublets
NS810_CTTGGCAAAGCG	Plasma
NS810_CTTGGGTAACGG	Plasma
NS810_CTTGTGACACTG	cDC
NS810_CTTTAACCCGGT	Plasma
NS810_CTTTGATTCCTA	HSPC
NS810_CTTTTCCAAACC	CD8Naive
NS810_CTTTTTAATTCC	Plasma
NS810_GAAAAATGGATA	cDC
NS810_GAAACTTCAATG	pDC
NS810_GAAAGGACGCTT	Doublets
NS810_GAAAGTTAGACC	Doublets
NS810_GAAATAAAAGTT	Plasma
NS810_GAAATATACCCC	Doublets
NS810_GAAATCTTTATC	Plasma
NS810_GAAATTAGATTG	cDC
NS810_GAAATTGCAATA	CD4Memory
NS810_GAACCAGGAAAT	B
NS810_GAACGCTGATTA	Doublets
NS810_GAACGTTGTTAG	HSPC
NS810_GAACTTCTAAAA	Doublets
NS810_GAAGGTAGATCG	CD4Memory
NS810_GAAGTCTCGAGG	Plasma
NS810_GAAGTTCATCAC	Doublets
NS810_GAAGTTCCTACT	Doublets
NS810_GAAGTTGCCGTC	Doublets
NS810_GAAGTTGTTCGT	Doublets
NS810_GAATCCGCCCAG	Doublets
NS810_GAATCGAGGGAA	Plasma
NS810_GAATCGTGAGTC	NK
NS810_GAATGGTACTGA	Plasma
NS810_GAATTTGCAATC	Doublets
NS810_GACAAACGGATA	CD8Memory
NS810_GACAAGTGATAA	Doublets
NS810_GACACACCGAAA	Doublets
NS810_GACAGTATAATA	Doublets
NS810_GACATCTATAAT	Doublets
NS810_GACATGCCAACG	CD4Memory
NS810_GACATTATCCCG	Plasma
NS810_GACATTTAACAT	HSPC
NS810_GACCGATCTCAG	HSPC
NS810_GACCGGGAGCGG	Doublets
NS810_GACCGTCTCTTG	Doublets
NS810_GACCGTGGGATT	B
NS810_GACCTACATCAC	Doublets
NS810_GACCTCGGATGC	HSPC
NS810_GACGGCCCCACC	Doublets
NS810_GACGGCTGGGGG	Plasma
NS810_GACGTCGTCGAT	Doublets
NS810_GACTACTCGGCT	Doublets
NS810_GACTCTACGAAT	Plasma
NS810_GACTGTTTCCAT	Doublets
NS810_GAGCCCAACCCT	Doublets
NS810_GAGCCGCTTGCC	HSPC
NS810_GAGCTATGTGAC	Plasma
NS810_GAGCTGGAGGTA	Doublets
NS810_GAGGATCGCTAG	CD8Naive
NS810_GAGGATTACTGG	Doublets
NS810_GAGGGGGACAGG	ProB
NS810_GAGGTTCTTCAC	CD8TermExh
NS810_GAGTACATTTCC	cDC
NS810_GAGTACTTCGGT	HSPC
NS810_GAGTCCGTCAAG	Doublets
NS810_GAGTCTCTATCG	Doublets
NS810_GAGTGAGACCAC	cDC
NS810_GAGTGAGCATTT	Doublets
NS810_GAGTTACCTACG	Doublets
NS810_GAGTTGGAAACT	Doublets
NS810_GAGTTTAACAGG	Doublets
NS810_GATAAAATCAGC	Plasma
NS810_GATAAGGTACGC	CD4Memory
NS810_GATATCTCTTGA	Doublets
NS810_GATCAGGAACAG	Doublets
NS810_GATCCGGCGGAG	Doublets
NS810_GATCGAGCCGTC	HSPC
NS810_GATCTGTGGTTT	Doublets
NS810_GATGAGCGATCT	cDC
NS810_GATGATAGTTCT	Doublets
NS810_GATGCCCCCCGT	cDC
NS810_GATGCTAAATGC	Plasma
NS810_GATGGTGTAGTC	Plasma
NS810_GATTAAGGTTAT	cDC
NS810_GATTACTGTATA	Doublets
NS810_GATTAGTAAAAC	Doublets
NS810_GATTATGGTTAG	Doublets
NS810_GATTGAGTAGGT	HSPC
NS810_GATTGTAAATGT	Plasma
NS810_GCAAATTGCCCA	Plasma
NS810_GCAACGTGTCCG	cDC
NS810_GCAATCTAGGTC	Doublets
NS810_GCAATGAGTAAC	Plasma
NS810_GCACACTCCTAC	Doublets
NS810_GCACAGTATACA	Doublets
NS810_GCACAGTGGGCA	HSPC
NS810_GCACATCGAATG	Doublets
NS810_GCACCGAAGACG	Doublets
NS810_GCACGAGGTATA	Doublets
NS810_GCACGGTCTGAG	Doublets
NS810_GCACGTTCATCC	Doublets
NS810_GCACTCCCTTTC	Doublets
NS810_GCAGCGGACTTG	Doublets
NS810_GCAGGAGGGATC	Doublets
NS810_GCAGGATATAAT	Plasma
NS810_GCAGTACGTGGG	Doublets
NS810_GCAGTGGTATCA	Doublets
NS810_GCAGTGTTGAGT	HSPC
NS810_GCAGTTATGCAT	Doublets
NS810_GCATAACAAGTA	Plasma
NS810_GCATACACATTC	cDC
NS810_GCATACAGCAAC	Doublets
NS810_GCATACGGAATA	Doublets
NS810_GCATCAGGAGGT	HSPC
NS810_GCATCATGCATT	Plasma
NS810_GCATCCGCCCCC	Doublets
NS810_GCATGATATTTC	Plasma
NS810_GCATGTAATGCC	HSPC
NS810_GCATTGTGGTCC	Doublets
NS810_GCCCCGCGTTGT	Plasma
NS810_GCCCGTATCGTT	Doublets
NS810_GCCCTACACTGC	HSPC
NS810_GCCCTGAACTAC	HSPC
NS810_GCCCTGGATTGC	CD8TermExh
NS810_GCCCTTTCTCCG	Plasma
NS810_GCCGCTAATATT	cDC
NS810_GCCGTCTGCCTA	Doublets
NS810_GCCGTCTTTGAA	HSPC
NS810_GCCGTTGTCTCA	Plasma
NS810_GCCTAAATTTAA	HSPC
NS810_GCCTCCCGTGAG	HSPC
NS810_GCCTCTTCACGT	Doublets
NS810_GCCTGATTAAAG	Doublets
NS810_GCCTGCGCCGGT	Plasma
NS810_GCGAGGATGCCT	Doublets
NS810_GCGAGTGACGCC	Plasma
NS810_GCGCGAGAATCA	HSPC
NS810_GCGCGTGGAAGA	Doublets
NS810_GCGCTAAACCTG	HSPC
NS810_GCGCTAAGCGAA	Doublets
NS810_GCGCTCCCAGAT	HSPC
NS810_GCGGAATGTAAA	HSPC
NS810_GCGGCACCCGGT	HSPC
NS810_GCGGGTATTCCG	Plasma
NS810_GCGGGTTGCGAC	HSPC
NS810_GCGGTCAATAGG	Doublets
NS810_GCGGTGGCATCC	Doublets
NS810_GCGGTTGCTTGT	HSPC
NS810_GCGTAAATTGCA	Plasma
NS810_GCGTACCGGTCT	ProB
NS810_GCGTACTACGCT	Doublets
NS810_GCGTCACAGGCG	HSPC
NS810_GCGTCGATAGAC	Plasma
NS810_GCGTGGGACTAG	Doublets
NS810_GCTACTTATAGA	Plasma
NS810_GCTAGTTGTCAT	Plasma
NS810_GCTATGCATTCG	HSPC
NS810_GCTCAAACCACA	Doublets
NS810_GCTCAGGTTTTT	HSPC
NS810_GCTCCAAAGAGG	pDC
NS810_GCTCCACTCTAG	Plasma
NS810_GCTCGGCGTGTT	Doublets
NS810_GCTCGGTCTTCT	Plasma
NS810_GCTCGTCGTCCG	Doublets
NS810_GCTGACGGACGT	HSPC
NS810_GCTGAGCTCTAG	Doublets
NS810_GCTGCGAACCTA	CD4Memory
NS810_GCTGGAAGAGAG	Plasma
NS810_GCTGGCAGACTC	Plasma
NS810_GCTGGGTAGATT	cDC
NS810_GCTGGTCTAGTG	Doublets
NS810_GCTGTAGCCTAT	Doublets
NS810_GCTGTCACATTA	Doublets
NS810_GCTTAATTTCTC	Doublets
NS810_GGAAAGGCAGCG	HSPC
NS810_GGAAATAGTAAA	Doublets
NS810_GGAACAAATAAT	Doublets
NS810_GGAACATACACC	Plasma
NS810_GGAACCCCTATG	Plasma
NS810_GGAATAGCGCTA	Plasma
NS810_GGAATCCACTAA	cDC
NS810_GGAATCCCAAAA	Plasma
NS810_GGAATGCCATGG	Doublets
NS810_GGACCACCTGGC	Doublets
NS810_GGACGAGTGCGT	HSPC
NS810_GGACGCATATCT	HSPC
NS810_GGACTCGCGTAT	Doublets
NS810_GGAGAAATGAGT	CD4Memory
NS810_GGAGCCTAGATC	Doublets
NS810_GGAGGCTCGTTC	cDC
NS810_GGAGGGGGGCGC	Plasma
NS810_GGAGTAAGCTCG	cDC
NS810_GGAGTGTCGGCC	Plasma
NS810_GGATATCGCACA	Plasma
NS810_GGATATGCCGTT	Plasma
NS810_GGATCAGACAGT	cDC
NS810_GGATGCCATCGA	HSPC
NS810_GGATGCTATGGC	HSPC
NS810_GGATTACAGCGA	Doublets
NS810_GGATTACTTTTT	HSPC
NS810_GGATTTCAACAG	Plasma
NS810_GGCAACCCAAAC	Doublets
NS810_GGCAACTTCCCT	ProB
NS810_GGCAAGCTTACA	Plasma
NS810_GGCACCTGCCGA	Doublets
NS810_GGCACTCGCAGA	Doublets
NS810_GGCAGTAAGATT	HSPC
NS810_GGCCAATTTCCT	Doublets
NS810_GGCCAGGCTGCA	Plasma
NS810_GGCCCAGCGACT	Doublets
NS810_GGCCGTTGACAA	HSPC
NS810_GGCCTGCTCATT	Plasma
NS810_GGCGAGTCACCG	Doublets
NS810_GGCGATGGTTAG	CD8TermExh
NS810_GGCGCATATTGA	Plasma
NS810_GGCGTCAAATCT	Doublets
NS810_GGCGTGGCCGAA	cDC
NS810_GGCTATACTCAT	Doublets
NS810_GGCTCAAGCCTC	Plasma
NS810_GGGAATACCGGC	Doublets
NS810_GGGACCTCAAGG	Doublets
NS810_GGGAGAGACCCT	Plasma
NS810_GGGATCACTGGG	cDC
NS810_GGGATGAAATTC	Plasma
NS810_GGGCACGTCCCA	Plasma
NS810_GGGCCAGCGCGT	Doublets
NS810_GGGCGAACTCTC	HSPC
NS810_GGGCGCGAATAC	Plasma
NS810_GGGCTAACCACG	Plasma
NS810_GGGCTGGACCGT	HSPC
NS810_GGGGAGGACTAA	Plasma
NS810_GGGGCAGAAAGG	Doublets
NS810_GGGGGAAAAAAA	Doublets
NS810_GGGGGGCGTATC	Doublets
NS810_GGGGGGGAAACA	Plasma
NS810_GGGGGGGGAAAA	Doublets
NS810_GGGGTAACTTTC	Doublets
NS810_GGGGTAATCGCA	Plasma
NS810_GGGGTATCTTTT	CD8TermExh
NS810_GGGTATCAGATT	Doublets
NS810_GGGTATGTTGCC	Doublets
NS810_GGGTGTAGAGGA	cDC
NS810_GGGTTCAAACGT	Plasma
NS810_GGTACGGATGGT	Doublets
NS810_GGTATTTAACGC	Plasma
NS810_GGTCCCCAGCGA	CD4Memory
NS810_GGTCCGATCATC	Doublets
NS810_GGTCTCCGGCAA	Doublets
NS810_GGTCTGCTACCA	cDC
NS810_GGTCTTTTCAGT	Doublets
NS810_GGTGAACTAGTT	Doublets
NS810_GGTGACAAAACC	Doublets
NS810_GGTGACAGACGC	Plasma
NS810_GGTGCATGCTTG	Doublets
NS810_GGTGGAAAACAC	pDC
NS810_GGTGTGCGCTCT	Plasma
NS810_GGTTAATAGCGT	Doublets
NS810_GGTTAATTCTTG	Doublets
NS810_GGTTGCCCCGTT	Plasma
NS810_GGTTTCAGATAC	Doublets
NS810_GTAACTTTGACC	HSPC
NS810_GTACCATATGGG	HSPC
NS810_GTACCGGAAGAT	ProB
NS810_GTACGGCGACTG	Plasma
NS810_GTACTAGATCGC	cDC
NS810_GTACTCCGGGGT	Doublets
NS810_GTACTGTTGCAT	Plasma
NS810_GTAGCATATCAC	Doublets
NS810_GTAGCCGACCGG	Doublets
NS810_GTAGGCCCGCCC	CD8Memory
NS810_GTAGGTTCATTC	Doublets
NS810_GTATAATCATAG	HSPC
NS810_GTATAGCGGCGG	cDC
NS810_GTATCGCCGGTC	Doublets
NS810_GTATGGCCTGGC	Doublets
NS810_GTATGGTACCAC	Doublets
NS810_GTATTCTCTTGC	Doublets
NS810_GTCAAATTATCG	Doublets
NS810_GTCAAGCAGCAG	Doublets
NS810_GTCAGCATTGCG	cDC
NS810_GTCATCATTGGC	Plasma
NS810_GTCATCGCATCA	Doublets
NS810_GTCATGCATGAA	HSPC
NS810_GTCCACTAGTGA	Doublets
NS810_GTCCCACAGATA	Doublets
NS810_GTCCCTCGCTAG	HSPC
NS810_GTCGAGAGCATT	Plasma
NS810_GTCGATCGGGAG	HSPC
NS810_GTCGCTTTGTTG	Doublets
NS810_GTCGGGGCTGCC	Plasma
NS810_GTCTATCTCTCC	ProB
NS810_GTCTCCCATGCA	CD4Memory
NS810_GTCTGGGTGATT	Doublets
NS810_GTCTGTAATTTG	HSPC
NS810_GTCTGTCACTGC	CD8Naive
NS810_GTGACACTCCCA	HSPC
NS810_GTGACCTTTTCT	Plasma
NS810_GTGACGTTCACC	Doublets
NS810_GTGAGGGACCAG	HSPC
NS810_GTGATATATAGC	cDC
NS810_GTGCACATACGA	Plasma
NS810_GTGCACTGCGTA	Doublets
NS810_GTGCCCTAATGT	Doublets
NS810_GTGCCTAGACAC	Doublets
NS810_GTGCTGATTCTA	Doublets
NS810_GTGCTTATTCTG	HSPC
NS810_GTGGGTTAAATA	ProB
NS810_GTGGGTTAAGTC	cDC
NS810_GTGGTGTCACAG	cDC
NS810_GTGTAATGGTCC	Doublets
NS810_GTGTCCCCGCCG	Doublets
NS810_GTGTCCGGACCA	Doublets
NS810_GTGTTAAGCTCC	Plasma
NS810_GTTAATGTGTAG	pDC
NS810_GTTACCGTACGT	Doublets
NS810_GTTACGGCAAAG	Plasma
NS810_GTTCGTGTACAC	Plasma
NS810_GTTCTACGTGGC	Doublets
NS810_GTTGAGTTGCTT	pDC
NS810_GTTTACCCCTTG	Doublets
NS810_GTTTAGCATGCC	Doublets
NS810_GTTTAGGTGTCA	Doublets
NS810_GTTTCTGGGGAC	Doublets
NS810_GTTTTCCACACG	Plasma
NS810_GTTTTCCCGTAG	ProB
NS810_GTTTTGGATATT	Doublets
NS810_TAAACTTGACGA	Plasma
NS810_TAAAGGATCCGA	HSPC
NS810_TAACGATGTGCT	HSPC
NS810_TAACGGGCTAGT	Plasma
NS810_TAACTATTTTCG	Doublets
NS810_TAACTGAGCGAC	HSPC
NS810_TAACTGCCAATC	Plasma
NS810_TAAGAAAGAACT	cDC
NS810_TAAGAAGACTCA	HSPC
NS810_TAAGAATGTAGG	Plasma
NS810_TAAGCAAGCACT	cDC
NS810_TAAGCACGCCTG	HSPC
NS810_TAAGCAGTGGTA	Doublets
NS810_TAAGCCAGAACA	Doublets
NS810_TAAGCCGCTTGC	HSPC
NS810_TAAGGAGCAGTC	HSPC
NS810_TAAGGCCAGCAG	HSPC
NS810_TAAGGCCTGAGT	Doublets
NS810_TAAGGGAGCGAG	Doublets
NS810_TAAGTCTAGCTG	cDC
NS810_TAAGTGAGCCAA	Plasma
NS810_TAAGTTCATACT	HSPC
NS810_TAATCACGGGTC	cDC
NS810_TAATCATTGCGG	Doublets
NS810_TAATCCAGCCGA	CD4Memory
NS810_TAATGTACCTTA	Plasma
NS810_TAATTCCACCCC	Doublets
NS810_TACAACAAGTGG	Plasma
NS810_TACACCGACAGA	Doublets
NS810_TACACTAGTGGT	HSPC
NS810_TACAGACTGCTG	CD4Memory
NS810_TACAGTAACAAT	Doublets
NS810_TACAGTCCCTTG	HSPC
NS810_TACATACCCGTT	Plasma
NS810_TACATCTCTCGA	Doublets
NS810_TACATTACTTAC	Plasma
NS810_TACCAAGAGCGA	cDC
NS810_TACCACCCCCTG	cDC
NS810_TACCCTCTGCCG	Doublets
NS810_TACCGCAACACC	cDC
NS810_TACCTAGGTAAG	Plasma
NS810_TACGCGTGGGAC	Plasma
NS810_TACGCTCCCCGC	HSPC
NS810_TACGGCCGACCC	HSPC
NS810_TACTCGAAATAC	HSPC
NS810_TACTCGGCCAAC	Plasma
NS810_TACTGCACCGTC	Doublets
NS810_TACTGCTAGCGT	GMP
NS810_TACTGGGGTATC	HSPC
NS810_TACTTGCTAATA	CD8Naive
NS810_TAGAAACATCGA	cDC
NS810_TAGAGGCGCTTA	Doublets
NS810_TAGCAAAAAGAG	CD4Memory
NS810_TAGCAACAACTG	Plasma
NS810_TAGCAGCGTTCG	HSPC
NS810_TAGCATTAGTTC	Plasma
NS810_TAGCCATCGCAG	HSPC
NS810_TAGCCCTAGCCA	CD4Memory
NS810_TAGCGAAGGAAC	Doublets
NS810_TAGCGACCCGAA	HSPC
NS810_TAGCGAGCTATG	Plasma
NS810_TAGCGATTCCAA	Plasma
NS810_TAGCGGACTGGC	Plasma
NS810_TAGCTACTTGTA	Doublets
NS810_TAGCTCTAAAAA	Doublets
NS810_TAGCTTCAGTCT	Plasma
NS810_TAGGAGTCAGGG	Plasma
NS810_TAGGCCGAACCG	Plasma
NS810_TAGGCTAGACCT	Doublets
NS810_TAGGCTCCTGGT	HSPC
NS810_TAGGGAGGTTTC	Doublets
NS810_TAGGGCACATTA	cDC
NS810_TAGGTCCAGAAG	Plasma
NS810_TAGGTGGACCCC	Plasma
NS810_TAGTCCACGTGT	Doublets
NS810_TAGTCGGCCTTG	HSPC
NS810_TAGTGTTGAATA	Plasma
NS810_TAGTTCATTGCA	Doublets
NS810_TAGTTCGCGCTG	cDC
NS810_TATAAATACTCA	Doublets
NS810_TATAATGTCCTG	Doublets
NS810_TATACCATCCAT	HSPC
NS810_TATACTGAAACC	cDC
NS810_TATACTGTGGGC	Doublets
NS810_TATAGAAACCGT	HSPC
NS810_TATAGGAAGGTG	CD4Memory
NS810_TATATCGCGGAG	Doublets
NS810_TATCAATCTTTG	Plasma
NS810_TATCACTCAGAA	Plasma
NS810_TATCAGATGACC	cDC
NS810_TATCCCAACACA	HSPC
NS810_TATCGCCAAGGA	Doublets
NS810_TATCGGAGCGAG	Plasma
NS810_TATCTAGTCCCA	HSPC
NS810_TATGAGAGTGGA	HSPC
NS810_TATGATGCCAGT	Doublets
NS810_TATGCCAGACTG	Plasma
NS810_TATGCGGCGACG	Doublets
NS810_TATGGGTGAACG	pDC
NS810_TATGGTACCAGG	Plasma
NS810_TATGTCAAGCAG	HSPC
NS810_TATTAGTCAGTA	cDC
NS810_TATTATTACGCT	Plasma
NS810_TATTCAGACACA	Doublets
NS810_TATTCGGAAACG	Doublets
NS810_TATTGCCTCCAT	pDC
NS810_TATTGTCATCAT	Plasma
NS810_TCAAGGCGAGCC	Doublets
NS810_TCACAAAGGTAG	Doublets
NS810_TCACAACAATGA	Doublets
NS810_TCACAGACAGGT	Doublets
NS810_TCACAGAGCGGC	cDC
NS810_TCACCACCAGAC	Plasma
NS810_TCACCCTACCGG	Plasma
NS810_TCACCCTCCCAC	Doublets
NS810_TCACCCTTCACC	HSPC
NS810_TCACCGAGATCT	Plasma
NS810_TCACGCCGATTT	HSPC
NS810_TCACGTAATCCG	HSPC
NS810_TCACTCCCCGGA	Plasma
NS810_TCACTCCGGTTT	Doublets
NS810_TCACTTCGTGGT	Doublets
NS810_TCAGAAGCATCG	Doublets
NS810_TCAGCGCCGCGA	HSPC
NS810_TCAGCTGGGCCC	Doublets
NS810_TCAGTACAACTC	Doublets
NS810_TCAGTTCAGCGC	Doublets
NS810_TCATACGTGACC	HSPC
NS810_TCATGCATCAAC	Doublets
NS810_TCATGCTTATCC	Doublets
NS810_TCATGGCAGGCC	pDC
NS810_TCATTACTGCAC	Plasma
NS810_TCATTCTTACGC	Plasma
NS810_TCCAAGAAGTTG	Plasma
NS810_TCCAAGGGATAG	CD8Memory
NS810_TCCAATGTCGTC	Plasma
NS810_TCCACAACTTCT	Doublets
NS810_TCCAGATCGCGG	Doublets
NS810_TCCAGGCAGCCG	cDC
NS810_TCCATCTAAGGG	HSPC
NS810_TCCATTGACTTC	HSPC
NS810_TCCCAAATCAAT	CD4Memory
NS810_TCCCAGCAGCCT	Plasma
NS810_TCCCAGTGGATG	Doublets
NS810_TCCCCCGGTCCG	CD4Memory
NS810_TCCCCTGATAAC	Plasma
NS810_TCCCCTTTCCTA	CD4Memory
NS810_TCCCTACTAGTC	Doublets
NS810_TCCCTCCAGGTG	Doublets
NS810_TCCCTCGTTTCA	Doublets
NS810_TCCGCCTAGGAC	Doublets
NS810_TCCGCGAGGGAT	cDC
NS810_TCCGCTCTCACT	HSPC
NS810_TCCGGCCAGTTG	Doublets
NS810_TCCGGTGGTAAT	Plasma
NS810_TCCGTTTCCTTG	HSPC
NS810_TCCTAAGCAGTG	Doublets
NS810_TCCTACAATGGG	Doublets
NS810_TCCTACTTATAC	HSPC
NS810_TCCTCATTTGAT	Doublets
NS810_TCCTCCATAGCG	Doublets
NS810_TCCTCCGGTTCG	CD4Memory
NS810_TCCTCTACACTC	Plasma
NS810_TCCTGCCAATCC	Plasma
NS810_TCCTGGTACATA	cDC
NS810_TCCTTGCGCACA	cDC
NS810_TCGAAAAGTCCT	Doublets
NS810_TCGACGTTTCAT	Plasma
NS810_TCGAGGACCGCC	Plasma
NS810_TCGAGGAGCTGC	Plasma
NS810_TCGAGTGCCGCA	HSPC
NS810_TCGATCGTAGTT	cDC
NS810_TCGCACTCCCGC	Doublets
NS810_TCGCAGGCCTTC	Doublets
NS810_TCGCCGGGGCCT	Plasma
NS810_TCGCGAGTGTTA	Doublets
NS810_TCGCTAATATAT	cDC
NS810_TCGGCCGCATTC	Plasma
NS810_TCGGCCTTAGGC	Doublets
NS810_TCGGCGTGGAGC	CD4Memory
NS810_TCGTATCGAGCG	cDC
NS810_TCGTTGCGCGAT	Plasma
NS810_TCGTTGTAAGGC	HSPC
NS810_TCGTTTTTATCA	HSPC
NS810_TCTAACCCGCAG	cDC
NS810_TCTATCTCCAAT	Plasma
NS810_TCTATGCGCCAT	NKT
NS810_TCTATTTCCTAT	Plasma
NS810_TCTCGATATCTA	CD8TermExh
NS810_TCTCGTAACCTC	Plasma
NS810_TCTCGTAGGGAG	Doublets
NS810_TCTGAAGCGTGC	Doublets
NS810_TCTGATCAAAGC	HSPC
NS810_TCTGCGCAGGAA	Plasma
NS810_TCTGGGCATGGA	HSPC
NS810_TCTTCGTGAAGA	CD4Memory
NS810_TCTTTACGCTGC	cDC
NS810_TCTTTCTTGCGG	HSPC
NS810_TGAAACAATGCT	Plasma
NS810_TGAAAGGCGTAG	Doublets
NS810_TGAAATTACCCG	Doublets
NS810_TGAACGAGGCAC	Doublets
NS810_TGAACGTTTGAT	Plasma
NS810_TGAAGACACCGG	cDC
NS810_TGAATGCTAGGC	Plasma
NS810_TGACAGTAATAA	Plasma
NS810_TGACCCTGTCCT	Plasma
NS810_TGACCTCCTAAT	Doublets
NS810_TGACGTGGTGTC	HSPC
NS810_TGACGTTTAGTC	HSPC
NS810_TGACTGAAAACA	Plasma
NS810_TGACTGTGACAT	cDC
NS810_TGAGAAGTCTCC	Plasma
NS810_TGAGATAAGATT	Doublets
NS810_TGAGCAAATCAC	cDC
NS810_TGAGCCATGCGA	cDC
NS810_TGAGCCCTCAGA	HSPC
NS810_TGAGCCTAGCGA	Plasma
NS810_TGAGCGGTTCCT	Doublets
NS810_TGAGGTGCTAGA	Doublets
NS810_TGAGTAGCTCCA	Plasma
NS810_TGATACAAGAGT	HSPC
NS810_TGATAGTACTAT	HSPC
NS810_TGATCCAAAGAA	Doublets
NS810_TGATCGGTTAGG	Doublets
NS810_TGATGGAGAAAA	Doublets
NS810_TGCACCCATATA	HSPC
NS810_TGCACCCTTGGG	HSPC
NS810_TGCACGTGAGTG	Plasma
NS810_TGCACTTATGGC	HSPC
NS810_TGCAGCTGCACT	Plasma
NS810_TGCAGTATAGGC	pDC
NS810_TGCCAGATCCGG	HSPC
NS810_TGCCGCATTCCG	Doublets
NS810_TGCCGGTGTCAC	HSPC
NS810_TGCCGTATAAGG	Doublets
NS810_TGCCGTTCCGAC	CD8Naive
NS810_TGCCTCGTGTCC	Doublets
NS810_TGCGAAGTGAGT	Plasma
NS810_TGCGGAACAAGA	HSPC
NS810_TGCGTTACTTCT	Plasma
NS810_TGCTAAGGTGCG	HSPC
NS810_TGCTACAAACTA	Doublets
NS810_TGCTAGTAAGTT	Doublets
NS810_TGCTCCCCTATA	Doublets
NS810_TGCTCCGTGCCT	Doublets
NS810_TGCTTGCAACTA	Doublets
NS810_TGCTTTAACCAC	cDC
NS810_TGGAAAGTGACG	Plasma
NS810_TGGAACAAGCAC	HSPC
NS810_TGGACAATCAGG	CD4Memory
NS810_TGGACTCTAGCC	Doublets
NS810_TGGAGACGAGGC	Doublets
NS810_TGGAGCGGTCGA	Doublets
NS810_TGGAGGCAGGCG	Doublets
NS810_TGGATCTGTTGA	HSPC
NS810_TGGCAACATGAC	Plasma
NS810_TGGCACCGATCC	Plasma
NS810_TGGCATCGCTAC	HSPC
NS810_TGGCCTAGAGAT	Plasma
NS810_TGGCGTAGCCGG	pDC
NS810_TGGCTCCCATCA	Plasma
NS810_TGGCTGTTATTT	HSPC
NS810_TGGGAACAATAG	Doublets
NS810_TGGGAGTGAGGG	Doublets
NS810_TGGGATACCGGT	HSPC
NS810_TGGGCACGCAAG	HSPC
NS810_TGGGGATCCGAC	CD4Memory
NS810_TGGGGGGGGGGG	Plasma
NS810_TGGTAACGGTCT	Doublets
NS810_TGGTCACACATG	Plasma
NS810_TGGTCGACCATC	cDC
NS810_TGGTTAATGGCT	Doublets
NS810_TGTACGTGCGAC	cDC
NS810_TGTACTGTAGAT	Doublets
NS810_TGTAGACTACGG	Doublets
NS810_TGTAGAGCGTAG	cDC
NS810_TGTATCTTTCGG	cDC
NS810_TGTATTGCTACT	Doublets
NS810_TGTCAACGTCCA	HSPC
NS810_TGTCAATGGGGT	HSPC
NS810_TGTCAGTGAAGC	Doublets
NS810_TGTCATGTGAGA	HSPC
NS810_TGTCCATCCGTG	Doublets
NS810_TGTCGAGCTATA	Plasma
NS810_TGTCGCATAATA	Doublets
NS810_TGTCGCGGACTG	HSPC
NS810_TGTCGCGTGACA	Plasma
NS810_TGTCGTCCATTA	Doublets
NS810_TGTCTGATTTCG	HSPC
NS810_TGTCTGGCGAAC	HSPC
NS810_TGTGCAGAACCT	HSPC
NS810_TGTGCTAAAAGT	HSPC
NS810_TGTGGATTCTCA	HSPC
NS810_TGTGGCTACAGC	HSPC
NS810_TGTGGGGGCCGT	HSPC
NS810_TGTGTATTGACC	Plasma
NS810_TGTTCTAGGATG	Plasma
NS810_TGTTGACGTTCT	cDC
NS810_TGTTGATCTGAA	HSPC
NS810_TGTTGCTTGCCA	ProB
NS810_TGTTGGCCCAGT	cDC
NS810_TGTTTGTAGTCT	Doublets
NS810_TGTTTTAGAAAG	Doublets
NS810_TGTTTTTACTGA	Plasma
NS810_TTAAACTTACCT	Plasma
NS810_TTAACAAGAGGG	Plasma
NS810_TTAACCAGTGTG	Doublets
NS810_TTAAGAACACTG	pDC
NS810_TTAAGACCGTGC	Doublets
NS810_TTAAGTATCCAC	Doublets
NS810_TTAATAACGTTC	Doublets
NS810_TTACAAGACCCA	Doublets
NS810_TTACAGGAGTCT	Plasma
NS810_TTACATGGCCCG	HSPC
NS810_TTACTACAAAGG	Plasma
NS810_TTACTGACGAGG	HSPC
NS810_TTACTGTCATTG	Doublets
NS810_TTAGTAAACTGC	Doublets
NS810_TTAGTTCCTTTA	Doublets
NS810_TTATAGGACCAT	HSPC
NS810_TTATAGTAGAGA	HSPC
NS810_TTATATCCAGAT	Doublets
NS810_TTATCAAGTATG	Doublets
NS810_TTATCGTCCATT	cDC
NS810_TTATGAATTCTG	Doublets
NS810_TTATGCATAAAC	Doublets
NS810_TTATGCTAGTTC	Doublets
NS810_TTATTAGAAGAC	Plasma
NS810_TTATTCTCGAGG	cDC
NS810_TTCAACGATCGG	HSPC
NS810_TTCAAGCCTTTT	HSPC
NS810_TTCAAGCGATGG	Plasma
NS810_TTCACGTAATCT	Doublets
NS810_TTCAGTACTGTC	Doublets
NS810_TTCATACAACCT	cDC
NS810_TTCCAACGGCCG	Plasma
NS810_TTCCAATTTTCG	Doublets
NS810_TTCGAACCTGTA	cDC
NS810_TTCGCGACCCCG	Doublets
NS810_TTCGCTACGGAG	Doublets
NS810_TTCGCTGGCGCC	Plasma
NS810_TTCGCTGTACCC	HSPC
NS810_TTCGGGTCCGTT	Doublets
NS810_TTCGGTGGAGAA	cDC
NS810_TTCGGTTCTAGA	Doublets
NS810_TTCGTATACGCT	HSPC
NS810_TTCGTGCATGAG	Plasma
NS810_TTCGTTAGAAGG	Doublets
NS810_TTCTACGTTACT	Doublets
NS810_TTCTATTTCCTT	HSPC
NS810_TTCTCAGTTATG	HSPC
NS810_TTCTCGTCACGG	Plasma
NS810_TTCTGTAGGTAC	HSPC
NS810_TTCTTTTTGCTA	Plasma
NS810_TTGAAACTTACG	Plasma
NS810_TTGACGATAGGC	Doublets
NS810_TTGAGGACCTCG	HSPC
NS810_TTGAGTTTGCAG	HSPC
NS810_TTGCAGTACTTA	Doublets
NS810_TTGCATGATTAT	Plasma
NS810_TTGCCAAACAAC	CD4Memory
NS810_TTGCCACAATCG	Plasma
NS810_TTGCCTCAAAAT	Doublets
NS810_TTGCTAGCACGA	Doublets
NS810_TTGCTGACCCGC	cDC
NS810_TTGCTGTGACCT	Plasma
NS810_TTGGATGATGTA	Plasma
NS810_TTGGATTGTACT	Doublets
NS810_TTGGGTTCTGAG	Doublets
NS810_TTGGTCGTAAGC	CD8Naive
NS810_TTGTACTGGTCA	Doublets
NS810_TTGTCTACCGAA	Doublets
NS810_TTGTCTATTAGA	cDC
NS810_TTGTTCCCAACG	Plasma
NS810_TTGTTCGCAAGC	cDC
NS810_TTTAAGTGCTAA	Doublets
NS810_TTTACCCTCAAA	Doublets
NS810_TTTACCGTATGA	cDC
NS810_TTTAGCTCACGC	Plasma
NS810_TTTAGGCTGGAC	Doublets
NS810_TTTAGGTAGGCA	Doublets
NS810_TTTAGTGAACAG	cDC
NS810_TTTAGTGTCGAT	cDC
NS810_TTTATACCACTG	Doublets
NS810_TTTATCCCCAAA	Plasma
NS810_TTTCAACAAGGC	HSPC
NS810_TTTCCGTCCAAC	Plasma
NS810_TTTCCTATCGGT	Doublets
NS810_TTTCGTGTCTAG	HSPC
NS810_TTTCTGGTAGTT	CD8Memory
NS810_TTTGAGTTAATA	pDC
NS810_TTTGCAACCCCC	Doublets
NS810_TTTGGGAACATC	Plasma
NS810_TTTGGGATCGGT	HSPC
NS810_TTTGGGCCCATC	cDC
NS810_TTTGTCCGCGAT	Doublets
NS810_TTTTACCAGGGT	Plasma
NS810_TTTTAGTCTCTA	HSPC
NS810_TTTTCAGCAAGT	Plasma
NS810_TTTTGGGTCGTA	Doublets
NS810_TTTTGGTGTTCA	Doublets
NS810_TTTTTACATGCG	Plasma
NS810_TTTTTTATGGAA	cDC
NS810_TTTTTTGCACAG	Plasma
NS810_TTTTTTTTTTTT	Doublets
NW_AAAACGCACATT	CD4Memory
NW_AAAAGGATATTG	Doublets
NW_AAACTACAGCAT	Doublets
NW_AAACTCGGTGGC	cDC
NW_AAACTTGATCCC	Doublets
NW_AAAGCTCGACCT	HSPC
NW_AAAGGGATGCTC	HSPC
NW_AAATAGTAGAAG	HSPC
NW_AAATCCGCGCGG	Doublets
NW_AAATCCGTCCGT	Doublets
NW_AAATCGTTATAC	Doublets
NW_AAATCTTCAGTA	Doublets
NW_AAATTAAAAAGT	Plasma
NW_AACAAGAGCCCT	cDC
NW_AACAAGGCGAAA	Doublets
NW_AACACGTCGCCC	Doublets
NW_AACACTCTCCAG	HSPC
NW_AACAGTCATTCG	HSPC
NW_AACAGTGCGATT	HSPC
NW_AACCATGCTAGC	Plasma
NW_AACCATTTTTTG	NKT
NW_AACCCGGACCCA	CD4Memory
NW_AACCTAATGGCA	Doublets
NW_AACCTTTGCGCT	HSPC
NW_AACGCGGGGCAG	Plasma
NW_AACGTCTCAACG	cDC
NW_AACTTCTTATTT	Doublets
NW_AACTTGTGGTAT	cDC
NW_AAGAAATGAACT	CD4Memory
NW_AAGACTCTTTTG	Doublets
NW_AAGAGCTAAAGC	Doublets
NW_AAGAGGCTCCTA	Plasma
NW_AAGCTAGCGTTG	Plasma
NW_AAGGCTGGTGTC	Doublets
NW_AAGGTACTGTGT	Doublets
NW_AAGGTGAAAACG	cDC
NW_AAGTCATCTCAA	Doublets
NW_AAGTCCGAGAAG	Plasma
NW_AAGTCTGCGCCG	HSPC
NW_AAGTGGGTCAAT	Plasma
NW_AAGTTAGTCGTG	cDC
NW_AAGTTCACAATT	HSPC
NW_AAGTTCTTAGGA	CD8Naive
NW_AATAGATAAGCT	Doublets
NW_AATAGGCGCGAG	HSPC
NW_AATCAATAGTAC	Plasma
NW_AATCAATCGGAA	Doublets
NW_AATCGCGTTCAC	HSPC
NW_AATCTTCCCTTG	HSPC
NW_AATTAAGGAGTC	Doublets
NW_AATTCGCAAAGA	CD4Memory
NW_AATTTAAGAGTC	NKT
NW_AATTTAGAGCAG	Plasma
NW_AATTTGCTGATT	Doublets
NW_ACAAATGATGCT	HSPC
NW_ACAACATAGATT	Doublets
NW_ACAACGAGGAAA	Doublets
NW_ACAACGTAGCGA	Doublets
NW_ACACCATCGCCG	Doublets
NW_ACATCGGACACG	Doublets
NW_ACATGATCGCCC	Doublets
NW_ACATGTAGGTAG	CD4Memory
NW_ACATGTGAGTAA	cDC
NW_ACATTCTTAGAA	CD8Naive
NW_ACCAAATCTGCA	Plasma
NW_ACCATAGACGTC	Doublets
NW_ACCATTGCCGCC	HSPC
NW_ACCCAAAGAGTC	Doublets
NW_ACCCAGGATACG	HSPC
NW_ACCCGTATATTT	Doublets
NW_ACCCGTCAGAAC	HSPC
NW_ACCCTAGTCGCA	HSPC
NW_ACCGCCGATTTA	Doublets
NW_ACCGGATGTTAG	Doublets
NW_ACCGTAGGCACG	cDC
NW_ACCTCTCGCGAT	HSPC
NW_ACCTTTGACGCC	cDC
NW_ACGAAGTCACAC	Doublets
NW_ACGACCGGCGAA	cDC
NW_ACGATCGGCCAT	Doublets
NW_ACGATGTCGGGG	Doublets
NW_ACGCCTGTGTCG	HSPC
NW_ACGGCAATCCTC	CD4Memory
NW_ACGGGTGCTAGT	Doublets
NW_ACGTGCCTAGTC	NKT
NW_ACTACACCGAGT	cDC
NW_ACTAGGGCGACC	HSPC
NW_ACTATCACAGGG	HSPC
NW_ACTCACTGTCTT	Plasma
NW_ACTCCCACGTCA	Doublets
NW_ACTCCGCGCTAC	Doublets
NW_ACTCGCGAAGGC	Plasma
NW_ACTCGGTAGGGG	HSPC
NW_ACTCTGGGACTT	Doublets
NW_ACTGAAAGGCCG	cDC
NW_ACTGGAGTGGGA	cDC
NW_ACTGGTCTCTAT	cDC
NW_ACTTACGTGTGC	HSPC
NW_AGAACAATTGTG	Doublets
NW_AGAATAATTAGT	Doublets
NW_AGACAGCTTCCC	Doublets
NW_AGACATAAAGTT	Doublets
NW_AGACATACGAGA	Plasma
NW_AGACATCTCGAA	Plasma
NW_AGACGACTATCG	CD4Memory
NW_AGACTAAGCAGG	Plasma
NW_AGACTAGACACT	Doublets
NW_AGAGATCGCAAC	Doublets
NW_AGAGATTTGTAG	Doublets
NW_AGAGCATTGGCT	CD4Memory
NW_AGAGGAGAACTT	Doublets
NW_AGAGGCTAGTCG	CD4Memory
NW_AGAGTCAGAATA	cDC
NW_AGATACAGTGCC	Doublets
NW_AGCAAAGTGGCA	HSPC
NW_AGCACTCGAACG	Doublets
NW_AGCCGCCCCCAT	Doublets
NW_AGCCGGTTTCCT	Plasma
NW_AGCCTGCGAGGG	Doublets
NW_AGCCTGTACACT	Doublets
NW_AGCGAGTTGGGC	Doublets
NW_AGCGATCCCCAG	HSPC
NW_AGCGGACGGTAT	Doublets
NW_AGCGTAGCATTG	HSPC
NW_AGCTCGGCTTGC	CD8Memory
NW_AGCTGGACGAAA	Doublets
NW_AGGAGGTTCGTT	cDC
NW_AGGATTGCTATA	Doublets
NW_AGGCACACCCAT	HSPC
NW_AGGCACTTACGG	Doublets
NW_AGGCAGTGCGAG	HSPC
NW_AGGCGAAGAAAA	Plasma
NW_AGGCTCTTATTT	Doublets
NW_AGGGAGAAATTA	Doublets
NW_AGGGGTTGGGGA	Doublets
NW_AGTAATCTTCAA	Doublets
NW_AGTACAAGCCCT	Doublets
NW_AGTATCAGGCGA	pDC
NW_AGTCATAAGCGT	cDC
NW_AGTCCCCTATCA	Plasma
NW_AGTCGCTACATC	cDC
NW_AGTCTGGAGAAA	cDC
NW_AGTTGCGACCAA	Plasma
NW_AGTTTCCCTCTT	Doublets
NW_ATAAACGTAGGC	Doublets
NW_ATACAGTGACGG	CD4Memory
NW_ATACCCGGTGGC	Doublets
NW_ATAGATAGCCTT	Doublets
NW_ATAGTTGAAAAA	Plasma
NW_ATATATGCTCAG	HSPC
NW_ATCAAAACTACT	CD4Memory
NW_ATCAGGACACGT	Doublets
NW_ATCCCACACGGT	HSPC
NW_ATCCGTGAGTGA	Plasma
NW_ATCGATGCGTCA	CD4Memory
NW_ATCGCTGTTTAC	Doublets
NW_ATCTAGGCACGG	Doublets
NW_ATCTGCCATGAG	Doublets
NW_ATGACGTGCTAG	Doublets
NW_ATGCAACCCAGG	HSPC
NW_ATGCAAGGCCCC	CD4Memory
NW_ATGCAGCGAATT	Doublets
NW_ATGCCGCTAAGT	Doublets
NW_ATGCGCGTGCCA	cDC
NW_ATGCTATCACCC	Doublets
NW_ATGCTCTTCTGT	HSPC
NW_ATGGCCCGATCA	HSPC
NW_ATGGGCTGGTCT	Doublets
NW_ATGGTTCTCCGG	CD4Memory
NW_ATGTATAAACAT	CD4Memory
NW_ATGTCGATCAGG	Plasma
NW_ATGTGCCAGCGT	HSPC
NW_ATTAAGTGCGCG	Doublets
NW_ATTACTGTCTGA	Plasma
NW_ATTATGACATTT	Doublets
NW_ATTCCCGCTAGC	HSPC
NW_ATTCCTCAGGAC	Doublets
NW_ATTCGATATCGG	Doublets
NW_ATTCTAGTACGT	Doublets
NW_ATTCTCTACGCC	Doublets
NW_ATTGCAGCTTAG	Plasma
NW_ATTGGACAAACT	Plasma
NW_ATTGGGCCGTTT	Doublets
NW_ATTTAAGTTTCC	HSPC
NW_ATTTAGGGAAAT	Doublets
NW_ATTTTCAAGTGA	Doublets
NW_CAAACCTTTACC	CD4Memory
NW_CAAAGGAGGAAG	Doublets
NW_CAACAGCCTGTA	Plasma
NW_CAACGAAGTCTG	Plasma
NW_CAACGATCTTCG	Doublets
NW_CAACGTGCTGTT	Plasma
NW_CAAGCGTGATAT	Doublets
NW_CAAGGAACAGAC	Doublets
NW_CAATCCCAAGTG	HSPC
NW_CACAACAAAGAG	HSPC
NW_CACACGGGATGT	Doublets
NW_CACAGCGCTCGG	Doublets
NW_CACCAACTTCCC	Doublets
NW_CACCACCCGCTC	Doublets
NW_CACCACTGGAAG	Doublets
NW_CACCACTTGCCT	Doublets
NW_CACCGCTACGTG	Doublets
NW_CACCGGCTACAT	Doublets
NW_CACCTATCAGCA	Doublets
NW_CACCTTACTCTG	HSPC
NW_CACGACCGGTAT	Doublets
NW_CACGTACCCACA	pDC
NW_CAGAATCAGGAT	Doublets
NW_CAGACTATGTGA	CD8TermExh
NW_CAGATTCAGGAA	Plasma
NW_CAGCGTACAACG	Doublets
NW_CAGGAATGATGA	Plasma
NW_CAGGCAGAACGT	HSPC
NW_CAGGGATGAAAT	Plasma
NW_CAGGGGTCCATG	Plasma
NW_CAGTCTCTTTGA	pDC
NW_CATAAAATAGAT	Doublets
NW_CATAATCACATC	Doublets
NW_CATAATCGGTGC	cDC
NW_CATACGTACCTC	HSPC
NW_CATAGGAATGCC	Doublets
NW_CATCCCGTGAAT	Doublets
NW_CATCCTAGATGA	Doublets
NW_CATCGTGGCTTG	Doublets
NW_CATGCGTGCTGT	HSPC
NW_CATGGGACCACC	CD8Naive
NW_CATGTTGTCCTT	Plasma
NW_CATTACGTCATT	Doublets
NW_CATTGGCACCTG	Doublets
NW_CCAATCTGTTTA	CD8TermExh
NW_CCAATGAGATAC	CD8Memory
NW_CCACACTTGAAA	Plasma
NW_CCACCCATGCAT	Doublets
NW_CCAGATCGGTCA	CD8Naive
NW_CCCAACGACGGG	cDC
NW_CCCAAGACCTTT	Doublets
NW_CCCAATAATGGT	Doublets
NW_CCCACCCGCGCC	Doublets
NW_CCCAGATCTGAA	cDC
NW_CCCATGTTGCGA	CD4Memory
NW_CCCCATAGTTCT	Doublets
NW_CCCGAATAATCA	CD8Memory
NW_CCCGACGGCCAT	HSPC
NW_CCCGAGTAAGTT	Plasma
NW_CCCGCTAGTACA	pDC
NW_CCCGCTCTCCTG	Doublets
NW_CCCGGCACCGGA	Plasma
NW_CCCGGTCTTGAG	Doublets
NW_CCCTAAGGGCTT	HSPC
NW_CCCTCATTTAAG	Plasma
NW_CCCTCTCAAGCT	Doublets
NW_CCCTCTTAGAGG	CD4Memory
NW_CCCTGTTTCATC	Doublets
NW_CCGAACGTCGGA	Doublets
NW_CCGACTAGTGGC	Doublets
NW_CCGATTGCGTTC	Doublets
NW_CCGCAACCCCTA	HSPC
NW_CCGGATATACGA	cDC
NW_CCGGGGTTGTCT	Doublets
NW_CCGGTCGACGAC	Doublets
NW_CCGTCCGTAGCG	Doublets
NW_CCGTCGATCTCT	Doublets
NW_CCGTTCCGACTT	Doublets
NW_CCTACCGACAGT	Doublets
NW_CCTAGCATAAGA	Doublets
NW_CCTATGACAGGT	CD8Naive
NW_CCTCAGGCCGGT	Plasma
NW_CCTCCCCACACG	Doublets
NW_CCTCCGGTTAAT	Doublets
NW_CCTCGTGAAAAA	Doublets
NW_CCTCTCGCCTTT	pDC
NW_CCTCTTCGGGCC	Plasma
NW_CCTGAGATATTG	Doublets
NW_CCTGAGCGTGGA	Doublets
NW_CCTGAGTGAACT	HSPC
NW_CCTGCAGCGATG	Doublets
NW_CCTTAGATGATG	Doublets
NW_CGAAGAGGATGA	HSPC
NW_CGAAGATGGGAA	HSPC
NW_CGAATTTTTCGG	CD8Naive
NW_CGACGCTATTAA	CD4Memory
NW_CGAGACTTAGAA	Doublets
NW_CGAGATTATGCT	cDC
NW_CGAGCAGGATCA	pDC
NW_CGAGCCTTCGCA	Doublets
NW_CGAGTTGCGAAT	Doublets
NW_CGATAGCCTTAA	Doublets
NW_CGATCAGATAGG	Plasma
NW_CGATCCTCCCTT	Plasma
NW_CGATGGCACGAC	Doublets
NW_CGCAGCAAAATC	Doublets
NW_CGCATCCTTCGA	Plasma
NW_CGCCAGGCTATA	Doublets
NW_CGCCCCAGCTTT	HSPC
NW_CGCCGCCGTGTT	Doublets
NW_CGCCGCTCGGAC	HSPC
NW_CGCCTTGCTCCT	CD8TermExh
NW_CGCGCGCGTTAT	Doublets
NW_CGCGCTCGTTGA	Doublets
NW_CGCGGTACTTTT	cDC
NW_CGCTAGCCTGAC	Plasma
NW_CGCTGTTCCAAG	HSPC
NW_CGGAGGCGTGGG	Plasma
NW_CGGAGTATGAAC	HSPC
NW_CGGAGTGATTTC	HSPC
NW_CGGCATACTTTC	HSPC
NW_CGGCCCGAGGGT	HSPC
NW_CGGCGGCTCGGT	Doublets
NW_CGGGAGGTATAA	CD8TermExh
NW_CGGGGCCGGAAC	Plasma
NW_CGGGGCGATAGC	Doublets
NW_CGGGTAGTGTGC	CD4Memory
NW_CGGGTATTGGCC	Doublets
NW_CGGGTCGACATC	CD4Memory
NW_CGGTCATTTTGC	CD4Memory
NW_CGGTCGGGAAAA	Plasma
NW_CGGTCTACGAAC	cDC
NW_CGGTGGTCCCAC	HSPC
NW_CGGTGTCGGGAG	Doublets
NW_CGTACCCGAGAC	cDC
NW_CGTAGCCAATTA	cDC
NW_CGTCAAGCGGGG	HSPC
NW_CGTCAATCACAT	Doublets
NW_CGTCAGGCTCGA	Plasma
NW_CGTCATAGCCGG	Doublets
NW_CGTCATTACGAG	Doublets
NW_CGTCATTCATTA	Doublets
NW_CGTCGAAGGAAA	Doublets
NW_CGTCTCCGGGCA	CD4Memory
NW_CGTGTGAGAGTG	Doublets
NW_CGTTAAACACGC	CD4Memory
NW_CGTTCCTTCAAG	cDC
NW_CTAACCTTGAGG	Doublets
NW_CTAACGCATTGC	Doublets
NW_CTAATAGACGCA	CD8TermExh
NW_CTAATTCGAGGA	Doublets
NW_CTACACTTTAGG	Plasma
NW_CTAGCTATTAGT	CD4Memory
NW_CTATATCCCCGG	cDC
NW_CTATTGGCCGTA	Plasma
NW_CTCATGTTGTTC	Doublets
NW_CTCCAGCGGCTC	Plasma
NW_CTCCCCGTAGGT	cDC
NW_CTCCGGCAACCG	Plasma
NW_CTCGACCGAGAC	CD8Naive
NW_CTCGAGCCACCT	HSPC
NW_CTCGCGTTTGCG	HSPC
NW_CTCTAGGAGACC	Doublets
NW_CTCTAGTCACGC	Plasma
NW_CTCTATACCTGC	Doublets
NW_CTCTGTCGGGTC	HSPC
NW_CTCTTACATCAC	CD4Memory
NW_CTGACCCATGTA	Doublets
NW_CTGATATTCCTG	Doublets
NW_CTGCCATTAGGG	HSPC
NW_CTGCGTGCTGCA	Plasma
NW_CTGCTCCCCGGG	CD4Memory
NW_CTGCTGGACGGG	HSPC
NW_CTGGAAAAATTG	Plasma
NW_CTGGATTCCTTC	Doublets
NW_CTGGCTGTATGT	HSPC
NW_CTGGGGCCTCAT	Doublets
NW_CTTACGGTATAG	Doublets
NW_CTTCCGCTCGCC	Doublets
NW_CTTCTGTGACTC	pDC
NW_CTTGAGGAGATC	HSPC
NW_CTTGAGGGAATG	Doublets
NW_CTTGCCGTGGTT	Doublets
NW_CTTGGCTAGCTA	HSPC
NW_CTTGGTATATAT	Doublets
NW_CTTTACGCGCCA	CD4Memory
NW_CTTTGGAGATAT	HSPC
NW_GAAACAGTACTC	Doublets
NW_GAAAGGCTGGCT	Doublets
NW_GAAATACTGGTC	cDC
NW_GAAATCGATTAG	Doublets
NW_GAACAGTTCCCT	cDC
NW_GAACATGGTGAA	HSPC
NW_GAACGGGTGCGC	cDC
NW_GAACGTTTTGCC	CD8TermExh
NW_GAACTCACAACC	HSPC
NW_GAAGCAGGTAGG	Doublets
NW_GAAGCGAGCCTG	CD4Memory
NW_GAAGCGCTCACG	Doublets
NW_GAAGTCGTTACA	Doublets
NW_GAATAGTCCTAG	cDC
NW_GAATATTCCTCT	Doublets
NW_GAATTACTTACA	pDC
NW_GACATACAGCTC	Doublets
NW_GACCCACAAAAC	Doublets
NW_GACCGCAGACTT	Doublets
NW_GACCGCTCACTT	CD4Memory
NW_GACCTTCAGTTC	Doublets
NW_GACCTTTCAGAC	Doublets
NW_GACGGCGTCTTA	Doublets
NW_GACGGGCTAGTG	Plasma
NW_GACGTCCGAGAC	Doublets
NW_GACTTGACAGGA	CD4Memory
NW_GAGAAACGGAAG	Doublets
NW_GAGACATGATTA	CD4Memory
NW_GAGACCACAGCA	Doublets
NW_GAGACCATTACT	Doublets
NW_GAGAGAGTGCTA	Plasma
NW_GAGATCCAGATA	cDC
NW_GAGCACCATCTC	Doublets
NW_GAGCATTCCCAC	HSPC
NW_GAGCCGGGACAG	cDC
NW_GAGGGATTAGAT	Doublets
NW_GAGTACTAGTAC	HSPC
NW_GAGTCCCAGATT	CD4Memory
NW_GAGTCGGATATC	Doublets
NW_GAGTCTTTCTTT	Doublets
NW_GATAATATCTGC	Plasma
NW_GATACCCTTTGC	HSPC
NW_GATACGGGCTGA	Doublets
NW_GATACTGGTACG	Doublets
NW_GATACTGGTCTC	Plasma
NW_GATAGAGCACAA	Doublets
NW_GATAGCTAGACA	Doublets
NW_GATATCTTAGTT	Doublets
NW_GATCAATCGAGA	Doublets
NW_GATCCGACACTA	CD4Memory
NW_GATCGGACACGA	Doublets
NW_GATTAACGCCTC	Doublets
NW_GATTCGCGGCCT	Plasma
NW_GATTGAGATATG	HSPC
NW_GATTGATGCGTA	Doublets
NW_GATTGGAAGTCG	HSPC
NW_GCAAGTAGGGAC	Plasma
NW_GCACCAGTTTAA	Plasma
NW_GCACGAAACACA	Doublets
NW_GCACTTCCTCTG	CD8Memory
NW_GCAGAATTAAAG	Doublets
NW_GCAGAGGTGGAA	HSPC
NW_GCAGTCGCCCTG	Plasma
NW_GCATAAGGTATA	Doublets
NW_GCATCGACAGTC	Plasma
NW_GCATCTTGTCAT	Doublets
NW_GCATTAACATTT	Doublets
NW_GCATTACCCCTT	HSPC
NW_GCCAATACATTT	Doublets
NW_GCCAATTGACAC	CD4Memory
NW_GCCACAATGTCA	CD4Memory
NW_GCCAGACTGACT	HSPC
NW_GCCAGTCGTACT	Doublets
NW_GCCATGTTTAAT	Doublets
NW_GCCCATCACAGT	Doublets
NW_GCCCGATCTGGG	Doublets
NW_GCCGCTACGGCC	Plasma
NW_GCCTAGCATGTT	Doublets
NW_GCGACCGAAGGC	HSPC
NW_GCGACCTCGTGA	Doublets
NW_GCGATCGAATAG	HSPC
NW_GCGCACATGCGG	HSPC
NW_GCGCACGTTGTG	Doublets
NW_GCGCCACTGTGA	Doublets
NW_GCGCGAATTACG	cDC
NW_GCGGAATACGTC	Plasma
NW_GCGGATTACATA	cDC
NW_GCGTACGACCGG	Plasma
NW_GCGTCATCGGGG	HSPC
NW_GCGTGGACGTCC	cDC
NW_GCGTTTGAGCTC	CD4Memory
NW_GCGTTTTAGATG	Doublets
NW_GCTAAATGGGCA	HSPC
NW_GCTACAAAGGGA	CD8TermExh
NW_GCTATTCGGCAG	Plasma
NW_GCTCAATCCGGA	HSPC
NW_GCTCAGAGTACG	Doublets
NW_GCTCATTGTGAG	Doublets
NW_GCTCGGAGCGAC	Doublets
NW_GCTGAAATCTGC	Doublets
NW_GCTGACCGTAGG	HSPC
NW_GCTGATACATTT	Doublets
NW_GCTGGATTCGGC	Doublets
NW_GCTGTTAAGAAT	Doublets
NW_GCTTGTCGAGCT	CD8Memory
NW_GGAAGCCCCTTC	Doublets
NW_GGAAGTATTGTC	Doublets
NW_GGACAAACATTG	Doublets
NW_GGACAGGCAGTC	Doublets
NW_GGAGGCTGGATA	Doublets
NW_GGAGGTTTAGAC	Plasma
NW_GGATAACTGAAC	Doublets
NW_GGATGCTTCGAA	Doublets
NW_GGATGTATTCTG	Plasma
NW_GGATTCAGTTGG	Doublets
NW_GGCAATACCATA	Doublets
NW_GGCACATACTAT	Doublets
NW_GGCAGTCTCTCT	HSPC
NW_GGCAGTTACCAA	HSPC
NW_GGCCCTACATTC	CD8Naive
NW_GGCCGACTCCGA	pDC
NW_GGCCTCATCATC	HSPC
NW_GGCGAATAGGGT	HSPC
NW_GGCGGCAGGCAG	Doublets
NW_GGCGGCTATATC	Doublets
NW_GGCGTTCCGCCA	Doublets
NW_GGCGTTGGTAAT	B
NW_GGCTCTCCTACA	CD4Memory
NW_GGCTTTATAACG	Doublets
NW_GGCTTTCCCGCG	Plasma
NW_GGGAAAAGTCCC	Plasma
NW_GGGAGTGTAGAA	Plasma
NW_GGGATGCGTAAC	Doublets
NW_GGGCATGTGGGC	Plasma
NW_GGGCCCAATTAG	Doublets
NW_GGGCGCGTATCA	Doublets
NW_GGGGCATGCGCG	HSPC
NW_GGGGTCCCAATT	Plasma
NW_GGGTCCCGATCG	Plasma
NW_GGGTTCGCGGTA	Doublets
NW_GGTACAACCAGA	HSPC
NW_GGTACTGCATCG	CD4Memory
NW_GGTAGATACCCA	HSPC
NW_GGTAGCGCGGTA	CD8Memory
NW_GGTAGCTGAAGC	Doublets
NW_GGTATTCTGCCT	Plasma
NW_GGTCCCAAATCG	HSPC
NW_GGTGCACCCTGC	Doublets
NW_GGTGCGACGCGG	Plasma
NW_GGTGGGGGGCTG	cDC
NW_GGTTCGACACGG	Doublets
NW_GGTTGAATCCCA	Doublets
NW_GGTTTCTCTCTA	Doublets
NW_GTAAGTGCGGGT	Doublets
NW_GTAATCTACATA	Doublets
NW_GTAATGTTGAAC	Plasma
NW_GTAGAGAGCCTT	Plasma
NW_GTAGTGAGCGTT	Doublets
NW_GTATACGCCGTT	CD4Memory
NW_GTATGGGTAAAG	Plasma
NW_GTATTCATGATC	Doublets
NW_GTATTGTCACGA	Doublets
NW_GTCATTCTGAAG	CD8Naive
NW_GTCCAAACATGT	CD4Memory
NW_GTCCAAGGAGGC	HSPC
NW_GTCCCCTCTCTC	Doublets
NW_GTCCCTAGCTAT	Doublets
NW_GTCCGATTACCG	Plasma
NW_GTCCGCGTTCGT	Doublets
NW_GTCCGGGGGTAT	CD8Memory
NW_GTCGCAAACAGC	Doublets
NW_GTCGCAACATAC	Doublets
NW_GTCGGACGTCCA	HSPC
NW_GTCGGTAATATG	CD8Naive
NW_GTCTAATCCACA	CD4Memory
NW_GTCTATGGACAT	CD4Memory
NW_GTCTTAGTCGCT	NK
NW_GTGATAATTCTA	Plasma
NW_GTGATCTCGGAG	HSPC
NW_GTGCAATATACC	Plasma
NW_GTGGGAACCGCA	Plasma
NW_GTGTACATTCTC	Doublets
NW_GTGTATCACTGC	HSPC
NW_GTGTCAACAATC	Doublets
NW_GTGTCTCAGCAA	Doublets
NW_GTGTTCAAGGCT	HSPC
NW_GTTACCGTACAT	Doublets
NW_GTTAGTACAGCA	Doublets
NW_GTTATTTCCCCA	HSPC
NW_GTTGACCGTCAA	Doublets
NW_GTTGCGGAGGGA	Doublets
NW_GTTGGATTCCCT	Plasma
NW_TAAAACCGAAAC	Doublets
NW_TAACAAGTCCCG	Doublets
NW_TAACAGACCGGA	Doublets
NW_TAACGAAAAACC	CD8Memory
NW_TAAGAGTTGGAA	Doublets
NW_TAAGGGGAAGTA	CD8Memory
NW_TAATACAAAAAA	Plasma
NW_TAATCAGCACGG	Doublets
NW_TACAACCTGCTA	Doublets
NW_TACAGCGGTTGA	Plasma
NW_TACATATTCGTC	cDC
NW_TACATCCGACAA	Doublets
NW_TACATCGTCTAG	HSPC
NW_TACCATAAATTT	Plasma
NW_TACCTGAGCACT	HSPC
NW_TACCTGTTCGTG	Doublets
NW_TACGCTAGCGTG	Plasma
NW_TACGGCGGGCTG	Doublets
NW_TACGGGGCAGGC	Doublets
NW_TACGTCTCCTCT	Doublets
NW_TACTTAAGTTTA	Plasma
NW_TAGAAAGCCCCA	pDC
NW_TAGCTCGTCTCT	Doublets
NW_TAGGATTGGAGT	Doublets
NW_TAGGCACTCTCT	Plasma
NW_TAGTTCTGGAAC	Doublets
NW_TATAACATGGCC	Doublets
NW_TATAATTAACGA	Doublets
NW_TATACAGGTACG	Doublets
NW_TATATACTGGTG	Doublets
NW_TATCCGGAGCAT	Doublets
NW_TATCGCGTACAT	Doublets
NW_TATGACAATTCA	Doublets
NW_TATGCTATGTAT	Plasma
NW_TATGTCTTCGTC	Plasma
NW_TATGTGGTGTGT	Doublets
NW_TATGTTGACGGT	Doublets
NW_TATTAAGTAAAT	Doublets
NW_TATTAAGTGCCC	HSPC
NW_TATTCGCGTGAA	HSPC
NW_TATTGTACGCCT	CD4Memory
NW_TATTTCCCCACA	HSPC
NW_TCAAAAGGCATT	HSPC
NW_TCAAACGTGAAG	Doublets
NW_TCAAAGTTCCAG	cDC
NW_TCAACTCTGAGA	Doublets
NW_TCAAGCGAATTA	Doublets
NW_TCAATTACGTGA	CD8TermExh
NW_TCAGATCACCCA	Doublets
NW_TCAGCGTGAGTC	cDC
NW_TCAGGAGGCAAT	Doublets
NW_TCAGGGATGTTA	Plasma
NW_TCAGTTTGAAAC	Plasma
NW_TCATCAGTACGA	CD4Memory
NW_TCATCTCTAAAC	Plasma
NW_TCATGCGTGAGT	HSPC
NW_TCCAAATCCATC	Doublets
NW_TCCAATAAATAA	Doublets
NW_TCCAATATTGCA	Plasma
NW_TCCACCGACAAC	CD8Memory
NW_TCCACGAATCGC	Doublets
NW_TCCCAGGTTTGC	Doublets
NW_TCCCCTAATAGG	Doublets
NW_TCCCGGGAACAG	HSPC
NW_TCCCTGCAGTGG	CD4Memory
NW_TCCGACTTCGCT	Doublets
NW_TCCGGCACAGGG	CD4Memory
NW_TCCTCTGTGCTT	Doublets
NW_TCGAAGCTTGGA	Doublets
NW_TCGATACCTCAG	Plasma
NW_TCGCGACACCAT	HSPC
NW_TCGCGATAGTGC	cDC
NW_TCGCGATCAGAC	Plasma
NW_TCGCTGAGATTT	CD4Memory
NW_TCGGCAGGCGGC	Doublets
NW_TCGGCATGTTCG	Doublets
NW_TCGGGTGCCTCT	CD4Memory
NW_TCGGGTTACTGT	Doublets
NW_TCGGTTATCTAG	Doublets
NW_TCGTAACCTAAC	HSPC
NW_TCTAATCATTCA	Doublets
NW_TCTACGTCAGCT	Plasma
NW_TCTAGACATCTA	Doublets
NW_TCTAGACTATAG	Doublets
NW_TCTATATGGTCG	cDC
NW_TCTATCACCGTT	CD4Memory
NW_TCTATGCTTACG	Doublets
NW_TCTCCACAAATG	Doublets
NW_TCTCCCTCCACC	Plasma
NW_TCTGCACGCGTA	CD4Memory
NW_TCTGCGTGTGGT	cDC
NW_TCTGGTGTGTTC	Plasma
NW_TCTGTAACTATT	Doublets
NW_TCTTACTCTTGA	Doublets
NW_TCTTTACGTTTT	cDC
NW_TGAAACTTTACA	cDC
NW_TGAAGGCGGCGG	Plasma
NW_TGAAGGGATGGA	cDC
NW_TGAATGGACCAT	HSPC
NW_TGACAACACAGG	Doublets
NW_TGACGTGCGCGC	cDC
NW_TGAGAATAGGCT	Plasma
NW_TGAGATTCCTAA	Plasma
NW_TGAGGTCGTCTT	Plasma
NW_TGATCCGGGTTG	CD4Memory
NW_TGATCTCCCATC	Doublets
NW_TGATGGGCGTGC	CD8TermExh
NW_TGATTGATCGGC	Plasma
NW_TGCAAACGTAGA	CD4Memory
NW_TGCAACCTTAAA	Doublets
NW_TGCCAGCGTGAG	Doublets
NW_TGCCTGACTCTG	Doublets
NW_TGCGATTGTGCA	cDC
NW_TGGAAAACCCGG	Plasma
NW_TGGAACAGCGGC	Plasma
NW_TGGACACATTGC	Doublets
NW_TGGAGTCAGCAT	HSPC
NW_TGGATTCTTTTC	Doublets
NW_TGGCCTTCTCTT	Plasma
NW_TGGCGACTTGTG	HSPC
NW_TGGCTCTCTACG	Doublets
NW_TGGCTTCGACTC	HSPC
NW_TGGGACGTCTGA	Doublets
NW_TGGGCCAGCTCC	cDC
NW_TGGGGTTTGTCT	Doublets
NW_TGGGTGAATTCT	Doublets
NW_TGGTCACCCGGT	Doublets
NW_TGGTGCGTCTCA	cDC
NW_TGGTTCTGAAGC	Plasma
NW_TGTAGCTAGCTT	HSPC
NW_TGTCACCGGGCG	Doublets
NW_TGTCAGGCAGAC	Doublets
NW_TGTCGATTGACA	HSPC
NW_TGTCTGCTATCG	Plasma
NW_TGTTACCTCGCC	CD8Memory
NW_TGTTGTACCAGG	Doublets
NW_TTAACGGTCTTC	HSPC
NW_TTAAGGAGCCGC	Doublets
NW_TTACGTCAATTA	HSPC
NW_TTACTGAAGGTC	Doublets
NW_TTAGAATACATC	Doublets
NW_TTAGAATGTTCG	Doublets
NW_TTAGATGGTTCC	CD4Memory
NW_TTAGTCTAAGTT	Doublets
NW_TTAGTTTTACCT	Doublets
NW_TTATCACTAGGG	Plasma
NW_TTATTCGCGATC	Doublets
NW_TTCCAAAACGAG	HSPC
NW_TTCCCGCGTTTT	Plasma
NW_TTCCTCATGCGT	Doublets
NW_TTCGAGTCAGAC	Plasma
NW_TTCGATGGTATA	Doublets
NW_TTCGCTAGACGT	CD8Naive
NW_TTCGGACCCTCT	Plasma
NW_TTCGGATATCTC	Plasma
NW_TTCGTGTCCCAT	Doublets
NW_TTCGTTTTCTGA	Doublets
NW_TTCTAGACGTGG	cDC
NW_TTCTGTAGAGTC	cDC
NW_TTCTGTTAGTGT	Doublets
NW_TTGACACTTATT	Doublets
NW_TTGAGTAAATAA	Doublets
NW_TTGCCCTTTGTC	Doublets
NW_TTGCCGCAATAC	Doublets
NW_TTGCGCACGTTC	Doublets
NW_TTGGTCCGCACA	cDC
NW_TTGTCGATGAAC	Plasma
NW_TTGTGCTCTAGG	Doublets
NW_TTGTGGTGTACT	Doublets
NW_TTGTTGCAGTCA	CD8Memory
NW_TTTAACCTGCAA	Doublets
NW_TTTCAAAACAGT	Doublets
NW_TTTCCCTCAATA	HSPC
NW_TTTGCTGATTTT	CD8Memory
NW_TTTTCCGCAGCT	Doublets
